	positive	neutral	negative	total	positive_list	neutral_list	negative_list
0005019281	93	8	8	109	[10, 8029, 7030, 6036, 4034, 2050, 5068, 71, 3086, 1093, 93, 6113, 7111, 9134, 9166, 6207, 178, 7197, 4216, 3208, 3216, 9232, 9237, 8239, 9240, 7219, 4245, 245, 8261, 9265, 8273, 8276, 3277, 2339, 9350, 7351, 9373, 8384, 8392, 7380, 8436, 9454, 5476, 460, 8480, 2509, 5530, 5535, 2536, 527, 7521, 8559, 3559, 1621, 1632, 1648, 656, 7656, 3702, 2714, 1699, 8702, 7687, 6759, 9752, 3724, 9755, 4761, 4763, 3733, 7714, 7733, 9803, 5802, 7750, 1784, 7769, 800, 6874, 2841, 1824, 9867, 5892, 2879, 2893, 4927, 9947, 4951, 900, 3921, 6977, 5994, 5998]	[1015, 3164, 3402, 1828, 8833, 870, 7911, 7953]	[9000, 1232, 4420, 9424, 3697, 5808, 3808, 5935]
0764007211	63	8	8	79	[5000, 6014, 8038, 8047, 9074, 6101, 8142, 3165, 167, 9206, 6238, 4217, 1260, 9301, 3289, 3321, 3339, 7329, 364, 5389, 5422, 9423, 4438, 6457, 9462, 9469, 9474, 9506, 9525, 6557, 2544, 1538, 7539, 4588, 6630, 2619, 634, 6681, 1665, 6713, 3686, 2710, 3712, 2723, 1722, 8734, 7740, 9805, 6822, 6835, 7787, 1848, 1859, 4898, 862, 4925, 5929, 4943, 6966, 2941, 8926, 2943, 938]	[4024, 4119, 7297, 8474, 1574, 7700, 4805, 2955]	[6138, 3634, 5704, 7716, 9949, 8938, 7922, 7925]
0780019172	0	0	3	3	[]	[]	[7000, 4209, 1569]
0738919039	14	2	2	18	[6000, 1091, 8110, 4163, 1264, 286, 8338, 5632, 1633, 4686, 6719, 6721, 9713, 7979]	[179, 8652]	[8541, 6726]
0767801962	17	15	8	40	[3000, 5008, 5042, 5064, 160, 189, 2357, 8399, 9439, 9530, 8526, 2550, 597, 9809, 3939, 5984, 8954]	[6053, 55, 1122, 1145, 6234, 221, 6291, 2283, 2329, 9359, 4723, 2729, 1715, 762, 801]	[5223, 7218, 7361, 384, 3547, 589, 9935, 7885]
0310263662	320	308	331	959	[1008, 3010, 3013, 7010, 3017, 1021, 3020, 8024, 5021, 5022, 5024, 7026, 30, 8036, 3041, 5040, 4046, 1057, 6054, 2056, 59, 2066, 6072, 6073, 6075, 8083, 5084, 3085, 2084, 2089, 3091, 6098, 89, 5095, 8096, 9096, 9108, 4111, 7108, 8117, 3115, 114, 8121, 4120, 6132, 7122, 4132, 9133, 6150, 9138, 5157, 6171, 3157, 8169, 7154, 6196, 171, 9182, 7172, 8192, 1195, 2196, 7181, 1198, 4196, 7184, 7189, 8208, 9209, 5216, 197, 9219, 9222, 5232, 8232, 226, 3233, 4244, 1248, 3242, 6281, 9269, 6286, 2267, 3256, 2276, 2277, 5284, 7262, 8291, 6314, 4295, 9302, 7285, 6328, 1310, 4311, 6333, 8320, 6340, 8325, 3318, 5337, 4348, 9352, 8359, 6378, 8371, 4371, 9374, 358, 361, 7356, 9378, 5383, 9384, 9386, 9387, 4384, 3375, 8393, 4392, 1394, 8402, 9403, 4407, 5409, 389, 2402, 5413, 4413, 2409, 2410, 5420, 7398, 2420, 4426, 406, 9430, 2428, 8430, 1424, 4432, 412, 413, 1428, 9442, 419, 1438, 9448, 7428, 1448, 3438, 4460, 3441, 2459, 9470, 9478, 3458, 6493, 2477, 7453, 6495, 3464, 5489, 4490, 8488, 6515, 3484, 488, 3488, 1500, 9515, 3494, 2511, 7485, 2513, 7494, 1517, 6548, 9537, 7507, 8533, 2537, 3523, 8540, 1535, 4557, 7520, 6574, 5569, 7526, 9566, 8555, 5575, 5576, 9573, 4577, 9580, 5591, 9591, 3565, 9593, 9594, 6610, 575, 8583, 5603, 5605, 582, 6622, 8595, 3590, 5616, 6639, 8609, 5631, 5640, 1611, 9662, 5667, 5676, 7650, 6709, 8671, 6715, 7657, 4706, 4716, 7672, 7674, 4731, 2716, 4750, 8717, 3725, 2738, 4759, 4767, 8731, 5768, 1735, 2756, 3749, 1741, 7729, 2768, 7734, 741, 3761, 3767, 3769, 2782, 9806, 1763, 764, 7755, 6834, 4816, 1782, 3795, 3805, 1804, 1809, 2831, 806, 9856, 4856, 5862, 1822, 812, 2848, 1834, 7820, 7821, 4881, 9884, 839, 4888, 8849, 3861, 849, 7836, 8860, 853, 5910, 5918, 6941, 7862, 5934, 4934, 1901, 4942, 1911, 7880, 5950, 896, 901, 902, 5962, 3931, 5967, 3944, 1943, 5981, 8952, 4992, 7929, 7931, 944, 8970, 3980, 8977, 8979, 1980, 966, 7960, 8994, 982, 7970]	[8000, 4001, 3004, 8004, 5006, 5007, 9011, 3014, 13, 5016, 6021, 21, 22, 8031, 9033, 3042, 9040, 37, 8051, 7049, 8062, 6059, 7059, 9060, 4059, 3062, 9065, 1070, 9068, 8075, 8084, 79, 2083, 4090, 4093, 1105, 7102, 3111, 1123, 116, 9120, 6130, 2128, 1131, 8129, 125, 2136, 6149, 1141, 7130, 136, 7139, 6163, 3151, 156, 7151, 8171, 161, 5180, 2177, 7160, 6205, 8191, 5198, 2191, 9190, 5204, 4198, 187, 5209, 6228, 5213, 2217, 2220, 5226, 5243, 8246, 9247, 3234, 7230, 242, 6275, 6285, 8266, 7250, 2275, 5282, 9281, 4278, 7265, 288, 9304, 1302, 297, 2314, 303, 2320, 2322, 6343, 2326, 3314, 7310, 7314, 7315, 1332, 9338, 7319, 2344, 3337, 4346, 9355, 5358, 343, 5363, 9365, 3360, 1367, 3361, 5378, 1373, 9383, 7363, 6407, 372, 6414, 4400, 4405, 5408, 3389, 9414, 5415, 1409, 399, 9420, 3403, 4428, 411, 7413, 2432, 5437, 5441, 6452, 6453, 8443, 1447, 2452, 9457, 2455, 3439, 2456, 440, 6475, 5467, 5471, 1461, 5472, 6498, 2485, 4493, 3483, 6520, 4513, 3486, 3487, 6523, 491, 2512, 8514, 4531, 2521, 9532, 7498, 9535, 6552, 4542, 6558, 6561, 7515, 4559, 5571, 6581, 4568, 4575, 1560, 8571, 4597, 7552, 8582, 7556, 8588, 588, 4616, 5623, 596, 4635, 1608, 2630, 9648, 3625, 2637, 1623, 2642, 4654, 3638, 632, 8641, 5666, 2658, 6687, 2667, 6693, 6694, 9687, 4691, 3671, 3675, 2691, 1678, 670, 6724, 3684, 4714, 1686, 1687, 3694, 9724, 8689, 3696, 6747, 5741, 4741, 8709, 7692, 1716, 2734, 4758, 3730, 6771, 716, 9761, 6783, 1732, 2759, 4781, 4787, 9790, 8753, 6818, 5813, 766, 9826, 1786, 3798, 5839, 5841, 6862, 8816, 7793, 8824, 3836, 2847, 1830, 3843, 3846, 9877, 4878, 1846, 6899, 847, 5902, 5903, 6922, 7846, 4913, 6934, 2897, 3891, 2906, 7865, 7870, 7878, 6963, 8903, 6965, 5955, 9954, 5959, 908, 7896, 4964, 2940, 3936, 5976, 2958, 8949, 1957, 9993, 3966, 947, 1978, 962, 2997, 7963, 983, 995, 997, 7987, 7995]	[7004, 5, 7006, 2009, 3019, 9019, 6024, 8026, 2029, 9036, 8039, 9041, 6045, 42, 2047, 4051, 8057, 7058, 8066, 7065, 3065, 5070, 66, 9069, 3076, 9079, 6088, 5089, 3089, 8091, 2091, 3095, 6111, 1106, 3103, 6116, 7104, 107, 3109, 8114, 2117, 1121, 5119, 121, 6135, 9126, 6144, 8135, 5145, 134, 3136, 1144, 7133, 139, 140, 4145, 8158, 9153, 146, 6173, 154, 5166, 4159, 3166, 169, 5186, 9180, 9186, 3179, 4191, 3188, 6217, 3189, 185, 2204, 4200, 1205, 2209, 4207, 4208, 5222, 4221, 2230, 8230, 2233, 3221, 9242, 4242, 232, 3232, 234, 5253, 3239, 2257, 8260, 6284, 2272, 1273, 4283, 6307, 5294, 9293, 6313, 4302, 8307, 9309, 5318, 300, 7296, 304, 5323, 9320, 309, 8330, 1327, 317, 2333, 4334, 3328, 2341, 2342, 5347, 5349, 7326, 1345, 2349, 8358, 9361, 3350, 8366, 9370, 355, 1366, 8375, 2372, 9379, 7359, 3367, 7362, 367, 6402, 8388, 5392, 7368, 8396, 3383, 1398, 9413, 1406, 7392, 8417, 4418, 8424, 6442, 409, 3412, 5443, 420, 5446, 6455, 2448, 7430, 3434, 9458, 9466, 5468, 9472, 4477, 2471, 2478, 2480, 4488, 9488, 3477, 2494, 2500, 4511, 7474, 7484, 9516, 6533, 502, 5527, 513, 3511, 1524, 8532, 1528, 1534, 9552, 9553, 1539, 7528, 6589, 9576, 3549, 4578, 4579, 6604, 8587, 3581, 5609, 6627, 4619, 5619, 5622, 4626, 9629, 6647, 2624, 6663, 8629, 621, 1622, 6669, 4658, 3637, 5669, 642, 8650, 9683, 6695, 6703, 8669, 5703, 665, 3681, 9711, 2696, 3688, 6739, 4735, 4738, 2727, 5744, 703, 3722, 6769, 8725, 3735, 6776, 2746, 1729, 9768, 724, 3746, 9780, 2761, 5781, 1743, 4785, 8757, 4801, 7748, 6826, 3786, 3791, 1781, 2807, 9840, 7781, 8804, 2818, 4838, 793, 5844, 6861, 2824, 8811, 7790, 1811, 7794, 3826, 4854, 2837, 8823, 5864, 5865, 3835, 819, 8829, 6887, 9873, 1838, 9880, 2863, 1853, 8856, 5899, 1866, 9902, 5911, 9909, 7852, 9924, 5927, 874, 7864, 4929, 6947, 3907, 4945, 5951, 7887, 3923, 9957, 4959, 913, 9964, 6991, 2952, 4976, 2953, 925, 926, 4978, 9982, 9989, 5993, 1959, 5995, 3960, 9995, 8962, 7939, 1975, 3982, 3996, 973, 7976, 7983]
076780192X	227	60	23	310	[0, 3006, 1006, 2008, 6010, 7013, 3025, 6031, 7033, 7034, 6037, 3045, 44, 1056, 8058, 9057, 57, 9063, 2072, 5087, 2085, 94, 5103, 8103, 8112, 7107, 6134, 4129, 1135, 2137, 7129, 5144, 5146, 2150, 6161, 7141, 1155, 4153, 2162, 1159, 1169, 1170, 6195, 7165, 9188, 8213, 9218, 8218, 9224, 5227, 5230, 4224, 1231, 223, 1240, 9246, 4248, 4251, 3244, 7243, 7245, 6287, 8272, 6316, 6325, 8313, 5321, 2319, 1319, 8334, 6351, 8344, 3335, 5354, 6379, 4367, 3363, 7360, 3372, 8391, 2387, 390, 6424, 8413, 3394, 1412, 4423, 4425, 5431, 8431, 7415, 7420, 1436, 1440, 1442, 1443, 7437, 1459, 451, 8466, 2465, 1463, 9479, 4481, 6503, 2488, 7464, 7465, 7471, 6518, 5511, 3491, 500, 6553, 2529, 526, 8537, 9548, 9557, 537, 6579, 9569, 551, 2572, 9587, 2590, 9601, 1585, 2601, 3592, 8602, 9623, 3604, 1602, 9635, 2629, 8627, 4651, 630, 4662, 2662, 2670, 5686, 9686, 5690, 3667, 4701, 5712, 2698, 3685, 8687, 5722, 5724, 4726, 9732, 699, 7690, 9746, 3717, 8710, 1712, 5755, 4754, 7702, 4771, 4780, 3758, 7746, 6816, 5807, 6821, 9811, 6831, 2798, 5823, 4819, 2804, 5831, 4825, 4831, 4832, 1797, 2820, 2823, 5847, 4842, 4843, 802, 3825, 805, 5857, 4852, 5858, 1819, 816, 1829, 4864, 4869, 1840, 1843, 8840, 5880, 7823, 5884, 1854, 8859, 7838, 2887, 6930, 5923, 5930, 2905, 4928, 9936, 889, 9941, 6985, 915, 8928, 4974, 2954, 927, 9984, 935, 942, 7937, 1976]	[1000, 1024, 1044, 1058, 2068, 3096, 2167, 6201, 3209, 7205, 9226, 216, 9245, 6276, 247, 2279, 1278, 4296, 9329, 6376, 5372, 5376, 7357, 366, 3377, 6427, 9421, 5430, 3414, 8500, 7495, 7511, 3556, 1564, 2577, 583, 9615, 6634, 8623, 9651, 3632, 1631, 3666, 6730, 3752, 7739, 1772, 6837, 6866, 5867, 7835, 4912, 2892, 898, 3929, 7909, 7913, 3957, 7948, 7989]	[7069, 3106, 2160, 7194, 5247, 3279, 6311, 6368, 3344, 5487, 7493, 7536, 9581, 7544, 7575, 6657, 1706, 749, 9802, 4807, 7834, 2951, 1947]
0780622561	1	0	5	6	[1150]	[]	[2000, 9023, 6157, 9585, 9912]
0764005693	46	17	9	72	[4000, 3005, 4027, 3036, 7039, 84, 8098, 3121, 168, 5188, 4190, 9213, 229, 7236, 5270, 1290, 5326, 8332, 5338, 342, 5405, 3449, 3455, 2473, 7479, 6542, 6606, 6696, 2688, 6728, 1719, 8721, 2749, 745, 3770, 7768, 7780, 7792, 8828, 828, 9891, 5895, 3873, 1893, 8892, 2919]	[25, 9273, 9275, 4272, 3331, 6393, 5399, 5416, 9428, 8490, 3522, 643, 2733, 1726, 2851, 1921, 4980]	[4007, 4267, 9299, 3348, 8649, 5684, 778, 5973, 8963]
0767819454	0	0	12	12	[]	[]	[5001, 6051, 7145, 8199, 6256, 4370, 5428, 5596, 5599, 9636, 7842, 2948]
0718000315	41	10	5	56	[9001, 7061, 9088, 7086, 8095, 9103, 7156, 1179, 9187, 4213, 1217, 1220, 8229, 224, 5259, 6278, 5279, 5287, 5299, 9336, 4342, 2368, 7411, 438, 1547, 3574, 7565, 6683, 5670, 4679, 3662, 694, 8703, 9766, 4775, 9778, 3773, 5896, 5915, 5926, 6987]	[8030, 5067, 2093, 5478, 1482, 9542, 7567, 4669, 3793, 3840]	[5113, 8182, 1190, 5702, 970]
0764001027	7	2	4	13	[7001, 2256, 9595, 2589, 2621, 6742, 7857]	[2359, 2393]	[362, 5600, 7735, 7952]
0767020553	33	3	5	41	[2001, 9012, 4039, 2109, 8139, 158, 1224, 253, 256, 1279, 5300, 7292, 2375, 4457, 6538, 3506, 6591, 3552, 4585, 4639, 5645, 9680, 7637, 2702, 689, 5782, 7758, 787, 4907, 6932, 6942, 6958, 8981]	[9084, 1317, 5592]	[2031, 3246, 8397, 5490, 7873]
0764006584	21	11	6	38	[5010, 16, 31, 4066, 6125, 6127, 4121, 1191, 5307, 1419, 9456, 5462, 450, 2475, 2611, 1599, 4647, 1654, 9728, 4817, 2942]	[1059, 5074, 73, 1257, 5290, 3285, 3437, 2489, 3593, 9628, 5691]	[3001, 8118, 5152, 864, 3914, 6978]
0767821599	1	1	4	6	[653]	[7324]	[1, 9046, 6260, 6981]
0767821513	0	0	6	6	[]	[]	[8001, 1250, 7514, 667, 8699, 3852]
0767819438	3	7	25	35	[1212, 7586, 1672]	[7042, 294, 470, 4640, 2712, 5765, 9963]	[5002, 7015, 7019, 2086, 3102, 8108, 1111, 9139, 9174, 2211, 6296, 4330, 345, 3410, 1455, 5508, 4516, 7551, 3571, 1596, 7635, 2684, 9842, 2869, 2913]
0767026128	26	3	3	32	[7002, 8119, 228, 5245, 255, 1285, 7270, 5301, 3302, 7305, 8342, 333, 5353, 2351, 1369, 4395, 9437, 1491, 4567, 2569, 2610, 3616, 6722, 6802, 3816, 7966]	[39, 3404, 3721]	[9227, 7274, 1323]
0767028627	5	5	2	12	[1009, 5101, 5291, 5525, 2545]	[5238, 586, 9748, 7761, 9837]	[3002, 9931]
0767803434	0	3	17	20	[]	[7064, 2195, 8837]	[6001, 1078, 8131, 225, 6262, 7258, 6374, 7383, 8450, 498, 8589, 728, 8832, 873, 4939, 2991, 7990]
078062369X	3	8	12	23	[9002, 422, 1650]	[2069, 2232, 8248, 9332, 3512, 9743, 3856, 9929]	[5072, 7106, 9122, 8328, 1450, 3459, 5543, 9677, 6756, 1713, 4779, 2903]
076400459X	21	5	1	27	[1001, 7031, 6172, 236, 9260, 4268, 2303, 5411, 4439, 5501, 4520, 2576, 3612, 2627, 6692, 2732, 709, 9836, 794, 2886, 8890]	[2244, 8423, 8803, 7796, 8967]	[1292]
0782008380	3	5	48	56	[4469, 7649, 5715]	[9101, 8314, 8454, 8459, 7447]	[2, 2036, 9070, 8089, 6158, 2171, 6229, 198, 3230, 5252, 8277, 1299, 5386, 2389, 7404, 9463, 7442, 9514, 6534, 5533, 8544, 8549, 7543, 1617, 7600, 3693, 8692, 3723, 4772, 9779, 7736, 6808, 4795, 760, 6823, 2810, 3830, 2856, 6894, 5888, 6909, 5907, 1902, 4967, 2957, 930, 1969, 8966]
0780023110	1	2	6	9	[2253]	[2002, 811]	[4227, 7268, 8467, 9730, 4910, 2968]
076400557X	39	2	1	42	[8002, 9007, 6027, 6086, 81, 83, 1092, 7110, 6142, 5143, 6187, 8180, 1188, 7175, 3217, 4286, 7272, 2292, 6332, 6390, 3428, 5492, 522, 5611, 9620, 610, 1618, 9654, 627, 672, 9772, 1792, 7826, 5921, 1894, 8893, 1927, 4989, 1994]	[7119, 8279]	[6244]
0764005707	36	12	24	72	[8021, 9071, 4076, 5118, 120, 7132, 8164, 2207, 8214, 233, 7259, 2298, 9317, 7308, 8333, 9341, 1338, 6394, 1388, 3425, 4478, 8478, 482, 2507, 6576, 7525, 7540, 4586, 4594, 1605, 4675, 2752, 809, 5894, 3901, 1929]	[7052, 2170, 1182, 5414, 9499, 1548, 557, 7660, 5855, 7853, 3886, 3955]	[9003, 5066, 7089, 3135, 8206, 9212, 2223, 4233, 299, 8351, 6387, 5403, 423, 2503, 6672, 1690, 710, 8760, 8869, 3894, 9926, 1955, 8974, 989]
0764004425	14	2	7	23	[3003, 3028, 296, 568, 2677, 1662, 4747, 4808, 1862, 1877, 4923, 1907, 8906, 1932]	[7066, 8410]	[8050, 7136, 2269, 9368, 510, 3866, 8918]
0767726227	136	19	7	162	[3, 2011, 1019, 7023, 1029, 9032, 5029, 5031, 5036, 7044, 9048, 8060, 8063, 6078, 77, 1100, 2123, 4134, 3140, 9148, 4154, 6181, 6190, 4171, 3181, 5220, 6253, 7224, 1247, 9248, 5265, 6297, 2289, 7273, 5297, 4301, 5311, 3296, 3299, 316, 2337, 4335, 3356, 354, 3371, 1391, 6417, 387, 8408, 3401, 5424, 9426, 3413, 6465, 448, 456, 8471, 4483, 9491, 4509, 6525, 495, 1501, 6531, 506, 9528, 4533, 8546, 542, 1545, 1553, 5583, 570, 1573, 6615, 578, 4618, 7597, 5653, 9655, 4660, 640, 5682, 5687, 8657, 7640, 7644, 4698, 6717, 3677, 6725, 2709, 5751, 3729, 7715, 8733, 9773, 8774, 2796, 1780, 773, 4820, 6840, 8793, 8797, 5838, 2817, 6854, 4837, 1806, 3821, 1816, 2840, 9861, 5870, 5875, 1839, 1847, 7840, 2881, 2883, 6923, 8871, 5914, 6935, 3899, 3920, 5958, 9985, 4984, 9988, 7934, 7965, 975, 7980, 7981]	[5041, 1107, 1117, 7128, 7252, 295, 6346, 4326, 8336, 6410, 584, 5615, 7588, 4655, 8723, 7757, 8791, 3844, 5965]	[9130, 8157, 6178, 4173, 1516, 761, 6828]
0767834739	6	10	41	57	[2157, 1376, 6423, 4443, 5675, 8944]	[9085, 1245, 8437, 4522, 8679, 7673, 1693, 7696, 8809, 2865]	[5003, 2019, 2023, 9050, 4055, 6064, 3116, 126, 131, 9157, 5177, 1173, 8187, 2203, 2210, 6272, 6318, 4339, 2348, 3362, 363, 1421, 5507, 1493, 5515, 7489, 7541, 4634, 1626, 2661, 9699, 5706, 704, 1746, 9791, 5817, 6876, 8868, 6954, 7917, 3976]
0767802470	188	65	35	288	[4002, 1003, 17, 1026, 7025, 4025, 3033, 2034, 7037, 9039, 6041, 3050, 5051, 2049, 1055, 1062, 5060, 6069, 1077, 8086, 6089, 9095, 1101, 7094, 6118, 2113, 8115, 8122, 4131, 6143, 8134, 6146, 2154, 5159, 6179, 4182, 184, 1207, 3197, 1219, 7204, 6246, 5235, 5240, 7226, 9261, 1265, 6288, 258, 5276, 3264, 8281, 9291, 5295, 2297, 8300, 1307, 1311, 6338, 9325, 6345, 9339, 326, 8364, 9362, 1361, 2367, 8376, 8381, 4376, 2377, 8390, 9392, 1396, 6420, 395, 2441, 7424, 1439, 3430, 9450, 5452, 1444, 6464, 6468, 8456, 9465, 445, 6480, 2463, 4480, 2487, 6508, 4499, 485, 7475, 490, 5518, 1506, 7491, 5536, 1518, 5542, 1526, 3529, 7516, 3531, 8550, 6586, 8570, 5601, 9606, 7564, 9617, 7591, 7592, 2632, 9653, 1625, 1628, 6673, 7622, 3645, 8648, 4677, 5692, 3663, 6710, 661, 9710, 9723, 4720, 3699, 7682, 1703, 4736, 705, 6760, 8714, 5760, 1725, 3744, 6787, 7727, 3763, 9796, 3765, 751, 8767, 775, 3809, 7788, 6865, 8813, 5851, 807, 2843, 4870, 2860, 5887, 2868, 844, 2872, 3864, 1867, 7839, 2885, 2895, 3887, 5924, 8891, 6957, 5947, 8910, 7888, 906, 2939, 8925, 917, 1945, 5982, 4983, 5987, 4994, 3989, 1984, 8996, 984]	[3031, 2041, 6077, 4091, 8099, 4137, 5147, 3142, 4151, 4187, 6227, 199, 8224, 4225, 1238, 8263, 8286, 8292, 290, 5313, 3320, 330, 8385, 1378, 2388, 9402, 3390, 5444, 6460, 1445, 8451, 9459, 7440, 1460, 9486, 4489, 1479, 5516, 7502, 8535, 3539, 7529, 5593, 2587, 6617, 9624, 1619, 620, 2673, 7669, 4734, 5738, 9784, 736, 8764, 7767, 784, 791, 2857, 1870, 5937, 2945, 1938, 8986, 2996]	[5013, 8035, 2032, 9058, 95, 7124, 2140, 7142, 8195, 4192, 3213, 6261, 3298, 9328, 1344, 7385, 398, 6434, 4464, 3475, 2495, 5513, 4653, 5672, 6734, 6751, 8846, 2866, 861, 4937, 892, 899, 9965, 1940, 7962]
0780627415	2	1	10	13	[7029, 8529]	[3198]	[6002, 6025, 9135, 8222, 8407, 462, 4496, 1584, 7804, 8870]
0307593908	11	0	1	12	[1002, 2082, 9271, 293, 2366, 2429, 5524, 8577, 1593, 3753, 872]	[]	[5028]
0767813871	2	1	4	7	[9004, 9895]	[5436]	[6487, 6665, 1895, 955]
0739046500	6	0	2	8	[7003, 5056, 9117, 1511, 5850, 5970]	[]	[6105, 9181]
0767002652	253	28	39	320	[8003, 8016, 3021, 2024, 9027, 27, 1034, 1035, 2039, 6047, 5054, 6065, 60, 8069, 6076, 9073, 8082, 5086, 4087, 1090, 4096, 6108, 6109, 4100, 6110, 2106, 101, 2107, 6115, 2112, 2114, 3108, 9112, 6123, 6126, 3118, 118, 6145, 2139, 8140, 8145, 8147, 7134, 8151, 3145, 6174, 7148, 2169, 3163, 164, 2181, 5194, 9194, 8200, 2202, 3196, 1210, 9214, 5219, 1222, 4222, 1225, 1226, 8240, 6266, 5251, 2251, 9253, 3241, 9264, 2262, 3252, 8268, 8270, 4270, 263, 2281, 3275, 4290, 2294, 7281, 8306, 6321, 8311, 6331, 4312, 3303, 3304, 1318, 9323, 2324, 3319, 6349, 8346, 2345, 8348, 1351, 4361, 5370, 1370, 5387, 7365, 2384, 9389, 1381, 6411, 2396, 6415, 392, 9411, 8416, 2416, 3407, 2424, 7409, 1422, 8429, 4431, 5435, 6449, 5442, 3423, 1437, 4445, 9446, 8448, 6466, 442, 446, 5473, 5474, 4475, 6491, 4486, 3467, 4497, 487, 9510, 492, 1503, 9517, 3497, 9521, 8519, 5532, 6544, 8521, 6549, 5547, 2534, 9543, 5551, 2542, 6571, 8556, 2561, 1557, 2571, 567, 4595, 4600, 3577, 9605, 3582, 2596, 2604, 592, 603, 4637, 4638, 5643, 4641, 1620, 622, 9660, 5659, 2646, 1635, 9684, 650, 9697, 1668, 3673, 3679, 4705, 5713, 9715, 2701, 8688, 7671, 5726, 684, 9727, 1697, 4733, 6750, 4749, 7706, 7710, 7713, 5772, 8742, 3755, 7731, 6809, 4797, 5801, 2797, 8782, 5825, 8787, 8788, 6852, 9841, 795, 1803, 1808, 2836, 9862, 6883, 825, 7813, 6893, 6895, 9883, 7828, 4890, 6912, 3868, 852, 8865, 9919, 1891, 3898, 880, 9934, 7874, 9942, 3911, 3912, 8907, 1914, 8912, 7893, 8923, 8929, 6995, 7907, 2961, 7932, 7954, 8991, 981]	[8012, 9055, 6133, 2141, 6184, 5191, 8269, 3284, 3306, 8329, 4345, 6388, 2373, 6412, 6458, 8499, 493, 2518, 7505, 543, 7531, 7532, 7584, 2647, 652, 679, 9759, 4858]	[8042, 5047, 9047, 9082, 1113, 133, 8165, 6198, 5275, 3259, 8304, 3310, 327, 8374, 2371, 7358, 382, 3405, 1426, 3429, 8477, 9501, 3526, 3533, 9565, 5635, 5665, 3650, 662, 9714, 3698, 4796, 3780, 3863, 9897, 6952, 2923, 3942, 1974]
0783211694	0	1	1	2	[]	[9114]	[4003]
0780630866	1	0	2	3	[8827]	[]	[6003, 1255]
0780656946	3	4	31	38	[5678, 5977, 936]	[2022, 2318, 720, 4963]	[9005, 2037, 64, 4071, 5090, 6097, 9104, 6159, 9150, 5165, 9185, 1272, 269, 5322, 7311, 9348, 5380, 7394, 434, 2454, 4507, 6559, 1543, 8564, 5641, 8708, 3831, 7832, 2934, 2950, 8941]
0764005316	28	2	3	33	[7005, 4077, 6215, 4210, 6237, 2227, 3214, 2296, 2306, 9354, 4365, 8447, 2464, 8507, 521, 9602, 5610, 4627, 3711, 6761, 6807, 1783, 3811, 834, 7844, 5941, 5978, 5999]	[5721, 7827]	[9631, 3768, 3778]
0780621832	1	1	3	5	[6197]	[4]	[6431, 8592, 4966]
0783223218	2	7	16	25	[6406, 1794]	[2094, 7349, 403, 6509, 744, 3771, 2827]	[2003, 4028, 1171, 9230, 6257, 6308, 2335, 7607, 8640, 721, 8746, 3779, 8876, 7908, 9976, 950]
0767019954	29	8	4	41	[6004, 2017, 2021, 3110, 3203, 6264, 1261, 1335, 1340, 9397, 2421, 4492, 3481, 6530, 512, 3573, 8600, 1594, 5649, 7604, 6670, 3653, 4688, 671, 9720, 8789, 2839, 9865, 9933]	[3016, 3206, 9313, 9346, 7384, 453, 6804, 7991]	[6245, 4561, 3600, 2828]
0780628535	2	2	13	17	[8041, 1180]	[4172, 1788]	[5004, 7125, 8257, 1266, 9270, 1267, 2301, 4304, 1696, 7725, 1892, 6976, 2993]
076784744X	1	3	18	22	[7566]	[9161, 6444, 4463]	[4004, 2052, 2071, 6100, 4241, 1268, 5305, 312, 2501, 9529, 2570, 8618, 5651, 4778, 1765, 7779, 6872, 8879]
0767087372	78	14	15	107	[1004, 4018, 41, 4069, 3100, 117, 5136, 9149, 1157, 9160, 5183, 1185, 4204, 4212, 8238, 6274, 5263, 4261, 8275, 4307, 7295, 6334, 8331, 4328, 5343, 2347, 9356, 9358, 1358, 6397, 5397, 9399, 8457, 5466, 5481, 6494, 2476, 9484, 2482, 3474, 9498, 1489, 6524, 520, 2581, 7547, 7555, 8590, 6637, 6642, 3615, 4642, 6666, 637, 5673, 4693, 659, 1670, 2707, 8698, 4756, 8722, 726, 2757, 3759, 5806, 8773, 2814, 1869, 7843, 8883, 1896, 9940, 3930, 2944, 3978, 969, 7964]	[9035, 2076, 7138, 1246, 8317, 350, 8439, 2547, 6573, 2555, 6598, 9640, 5803, 9918]	[1071, 88, 8156, 8202, 2260, 4359, 5483, 6582, 9612, 5671, 1771, 1918, 1923, 7933, 2979]
0767025075	3	3	2	8	[9006, 9024, 2385]	[6651, 8693, 8877]	[212, 1475]
0307142469	35	4	1	40	[2004, 2027, 2045, 6070, 3173, 2194, 1200, 6236, 3222, 4239, 7240, 4319, 1320, 4329, 3327, 3334, 2411, 3418, 5499, 5537, 3517, 4545, 5595, 8594, 4727, 698, 8744, 6825, 782, 3847, 9906, 5912, 9956, 4965, 923]	[7, 6015, 2245, 988]	[5966]
0767736680	102	7	6	115	[4005, 3055, 6060, 56, 9072, 6091, 4102, 8116, 8138, 4156, 5168, 5175, 6191, 2189, 2199, 4199, 9208, 6240, 214, 218, 219, 4237, 9249, 240, 1254, 9274, 1271, 261, 2280, 5298, 3286, 7283, 3322, 9340, 4337, 1343, 347, 6382, 360, 1384, 5395, 7389, 5417, 401, 5432, 6454, 8453, 3440, 1462, 6504, 8491, 4503, 6528, 7492, 517, 5550, 6572, 7523, 2563, 5578, 6592, 4612, 9616, 5618, 9630, 607, 4692, 6723, 5723, 3701, 6763, 2755, 9789, 742, 6815, 6832, 1778, 9831, 4826, 3803, 1801, 2822, 6873, 4861, 818, 9869, 1836, 6898, 7849, 4914, 4920, 1887, 875, 5931, 6979, 1934, 8935, 1946, 8956, 8990, 1990, 7996]	[9105, 1237, 8236, 7249, 421, 6502, 9775]	[8015, 9075, 2088, 5173, 6377, 3485]
0307514161	109	12	6	127	[9013, 7017, 8033, 35, 5046, 7046, 8059, 3063, 3066, 1083, 8088, 92, 9099, 4104, 9127, 7131, 8148, 1151, 5164, 159, 9167, 5182, 8184, 6218, 9200, 3195, 2214, 7201, 8219, 3224, 8237, 8242, 241, 5260, 4258, 1262, 7253, 9279, 272, 2290, 9292, 8298, 6329, 7331, 8362, 4366, 4373, 3366, 7370, 9407, 2405, 2408, 6430, 2417, 2422, 9436, 9449, 4455, 3448, 9468, 6497, 4508, 3490, 9536, 5544, 4546, 5561, 5570, 6599, 9611, 6646, 4644, 2634, 6659, 8628, 3636, 9667, 4678, 8660, 7646, 669, 8678, 7678, 690, 8697, 697, 2728, 3719, 6792, 6799, 5786, 7742, 4802, 6827, 2803, 9830, 3878, 3884, 3890, 1890, 3919, 7897, 912, 6989, 6990, 1965, 3973, 7951, 7973]	[2005, 48, 9100, 2243, 1408, 1441, 9505, 6650, 5654, 1646, 7685, 7717]	[1259, 9508, 7513, 4558, 8704, 7705]
0783223358	3	3	46	52	[4458, 8666, 6745]	[6310, 3340, 6901]	[1005, 5025, 1061, 7071, 7081, 1099, 137, 165, 3182, 7178, 5206, 5215, 4223, 3226, 325, 5369, 1365, 6385, 3378, 1416, 3411, 429, 6474, 4474, 8530, 3524, 3572, 6652, 8626, 5650, 2651, 9691, 6705, 9729, 3750, 8747, 6800, 3849, 6913, 1881, 1882, 1885, 3896, 1915, 5968, 3943]
0780631153	4	12	47	63	[4160, 277, 5357, 2655]	[51, 9077, 5200, 1203, 7344, 7446, 3460, 4703, 3720, 3859, 2882, 940]	[3007, 5038, 7050, 5071, 5080, 1089, 105, 8159, 9155, 6221, 213, 2263, 265, 2304, 1303, 7290, 6353, 6421, 8426, 1435, 4467, 2462, 2468, 9483, 1515, 4544, 3525, 8543, 4566, 9584, 3569, 1583, 3594, 8610, 7654, 6753, 722, 8740, 2770, 5797, 9812, 4821, 8806, 5908, 8882, 7924, 958]
0780628551	1	9	33	43	[8862]	[1167, 9255, 3291, 7371, 5421, 4649, 1641, 859, 3974]	[8005, 9067, 8102, 6107, 97, 2152, 6202, 5233, 9310, 3307, 1355, 8386, 4389, 4414, 402, 7405, 6447, 4482, 9562, 9568, 3560, 7577, 1606, 4657, 2671, 4684, 9731, 6841, 6881, 4911, 4930, 1937, 3984]
0767839277	0	1	4	5	[]	[1346]	[2006, 2096, 1389, 6522]
0780618564	0	1	8	9	[]	[609]	[6005, 5190, 7185, 1630, 7641, 5718, 8715, 1919]
0767809270	1	0	6	7	[11]	[]	[6, 8253, 310, 4602, 8632, 1884]
0767823990	1	0	2	3	[5005]	[]	[3456, 1681]
0767824555	1	1	2	4	[9008]	[4404]	[4072, 2686]
0767020308	86	21	18	125	[2007, 1016, 4014, 5026, 4033, 5048, 5077, 9080, 4084, 9097, 5107, 3132, 9147, 142, 6167, 5179, 1175, 8183, 1184, 194, 6235, 8215, 9233, 7227, 5256, 5264, 5266, 1282, 8284, 3290, 5327, 2325, 5335, 324, 348, 4360, 1360, 9393, 5433, 2446, 3445, 1465, 1472, 6505, 486, 9522, 9523, 8515, 8520, 3507, 3519, 3544, 4584, 2583, 6608, 2595, 3584, 3588, 5636, 6661, 3635, 6676, 1659, 2683, 8672, 682, 7676, 6748, 3716, 6778, 7753, 8775, 1773, 8776, 4823, 7772, 4851, 6871, 3851, 6940, 8884, 3926, 6994, 9975, 8971, 1985]	[2014, 5102, 4128, 9163, 3199, 7206, 6365, 9396, 380, 2490, 2504, 6587, 8563, 9644, 3651, 6767, 6857, 6915, 9930, 3916, 7884]	[3009, 6033, 6119, 111, 157, 7164, 8379, 3374, 8469, 7480, 2558, 3601, 9764, 1761, 3810, 1855, 7903, 3992]
0767819640	0	2	0	2	[]	[3008, 7628]	[]
0764003828	44	11	6	61	[6006, 8018, 6019, 20, 1030, 5049, 3099, 2105, 8106, 5114, 3139, 1183, 6204, 1199, 4232, 9295, 2300, 5310, 8350, 4375, 5385, 2379, 6403, 7397, 8435, 3433, 7488, 1541, 2584, 7576, 9625, 4643, 1636, 4709, 1683, 7666, 4760, 6795, 798, 3819, 5898, 3867, 5988, 9996]	[4273, 4411, 459, 5581, 1563, 7569, 7598, 9797, 6983, 9969, 7969]	[2087, 6277, 9405, 7623, 7728, 8786]
0780605799	1	1	7	9	[5359]	[3068]	[8006, 3162, 4363, 8418, 5574, 7778, 8940]
0773343032	0	1	10	11	[]	[4006]	[129, 6185, 9388, 1456, 1477, 1532, 8578, 9850, 1845, 9978]
0783222734	2	0	14	16	[1007, 8905]	[]	[7112, 5139, 3143, 2328, 7317, 8481, 3595, 3602, 8681, 1760, 9881, 9925, 1905, 5979]
076400235X	20	2	1	23	[9009, 1028, 8137, 4194, 7241, 5278, 9286, 370, 8412, 2434, 2479, 530, 5590, 2612, 2640, 648, 2679, 8728, 5909, 5943]	[1314, 9567]	[6090]
0764000969	4	1	1	6	[7007, 5872, 4900, 8964]	[5281]	[8207]
0767824571	4	4	13	21	[3079, 2378, 1385, 1680]	[2575, 8624, 6664, 1669]	[8007, 3035, 4135, 1294, 4390, 1392, 3384, 8508, 6560, 6580, 1637, 4687, 6902]
0767025784	3	0	3	6	[6048, 3292, 3731]	[]	[9010, 5332, 646]
0764002465	28	5	5	38	[7008, 6012, 87, 7098, 5161, 4260, 9268, 9334, 7325, 383, 7408, 5493, 5506, 7562, 9638, 7618, 6697, 5699, 4699, 1756, 754, 3817, 3818, 4857, 824, 2873, 4944, 3956]	[4040, 287, 7293, 9342, 5562]	[6040, 3124, 5241, 1312, 4650]
061529118X	4	0	1	5	[6007, 6018, 5034, 9810]	[]	[7871]
0780619609	0	2	6	8	[]	[1342, 4667]	[4008, 8123, 3131, 6241, 4406, 1614]
0767818024	0	0	4	4	[]	[]	[8008, 6147, 817, 8930]
0767851668	3	5	34	42	[8, 9176, 5362]	[7170, 3248, 6355, 4355, 7653]	[6020, 2044, 3052, 8097, 7114, 4149, 6176, 1196, 8235, 281, 8303, 5344, 4356, 7416, 6516, 518, 4547, 554, 613, 7614, 663, 5729, 717, 1748, 799, 2853, 855, 895, 7889, 3924, 2947, 8959, 2989, 7950]
0767817753	0	0	11	11	[]	[]	[6008, 5075, 8287, 9588, 9666, 660, 7697, 7730, 7811, 1904, 7912]
0780623134	3	0	10	13	[1010, 1457, 553]	[]	[7101, 4240, 3324, 9394, 6436, 7450, 5579, 771, 7861, 7994]
0767023765	44	10	5	59	[2010, 5039, 7045, 1049, 8067, 8109, 3117, 6164, 6170, 6177, 4174, 9195, 7188, 9252, 2327, 1334, 331, 7346, 2403, 3397, 2425, 4476, 2491, 1531, 2600, 7585, 6649, 3627, 629, 4682, 6714, 5737, 6766, 5843, 4877, 8850, 865, 8888, 7869, 4950, 6992, 2974, 2982, 8972]	[2064, 182, 8251, 394, 1519, 608, 1749, 4839, 2825, 2921]	[6211, 3257, 605, 8873, 2914]
0764005685	47	21	14	82	[3011, 3071, 6104, 7113, 3120, 3158, 5199, 7186, 192, 8221, 4226, 9256, 7244, 7257, 6302, 5364, 6396, 2383, 4388, 9404, 4424, 7456, 3528, 3538, 546, 6607, 577, 8596, 9634, 8630, 1688, 3751, 6842, 9835, 2821, 7807, 8842, 6927, 6938, 7872, 2937, 3938, 9974, 4996, 7943, 964, 992]	[2020, 1052, 1076, 1079, 173, 2190, 8210, 206, 8321, 3313, 6372, 5381, 5391, 4518, 2556, 1572, 7601, 9725, 5757, 6882, 3848]	[6039, 3155, 205, 2338, 7419, 7429, 6507, 3502, 8523, 5567, 1556, 573, 9607, 7831]
0780626966	1	2	6	9	[2358]	[1162, 9757]	[8009, 5037, 9519, 2838, 6886, 5933]
0767821556	1	3	3	7	[4465]	[8664, 7721, 783]	[9, 1336, 757]
0780618556	1	1	19	21	[3012]	[7627]	[9087, 149, 2229, 8245, 2270, 6350, 2370, 6409, 374, 5464, 6476, 6490, 4550, 544, 4582, 4631, 3639, 5964, 2985]
0767833902	3	5	53	61	[357, 5477, 2970]	[6084, 4331, 7386, 9533, 7545]	[4009, 1032, 1063, 5105, 2118, 6148, 6168, 5174, 8174, 5181, 9211, 249, 3267, 3301, 302, 1322, 2332, 2380, 1382, 376, 8414, 6428, 415, 9441, 1458, 5541, 2538, 9554, 5568, 7537, 9590, 6691, 8654, 6704, 2687, 4702, 9709, 4717, 5733, 692, 3736, 7782, 8815, 8844, 4886, 9889, 4909, 3888, 883, 6971, 3951, 9986, 7978]
0767836316	0	4	9	13	[]	[1011, 1609, 655, 1963]	[9111, 175, 4275, 8511, 3499, 1702, 2760, 5833, 1962]
0783222823	0	1	3	4	[]	[2622]	[6009, 1186, 4252]
0780620003	5	3	26	34	[5015, 8185, 478, 7473, 734]	[8132, 5268, 9851]	[7009, 7056, 4125, 8128, 3235, 3297, 4313, 6375, 4434, 471, 476, 4524, 4556, 8573, 7554, 1598, 5743, 9762, 1751, 1766, 7786, 4970, 9972, 1967, 1993, 7984]
0780656172	3	4	27	34	[8010, 3654, 6997]	[1023, 9092, 590, 4645]	[5043, 9110, 7117, 8144, 8178, 231, 1293, 7345, 2419, 489, 9545, 8547, 1540, 555, 3618, 7632, 8659, 1692, 2725, 9745, 2730, 7737, 3766, 1796, 814, 838, 903]
0767800958	13	1	1	15	[8011, 6058, 85, 2125, 5155, 3159, 4292, 4572, 2607, 2772, 5852, 7801, 1936]	[9734]	[2965]
0780620321	0	1	6	7	[]	[2608]	[4010, 6283, 7327, 6679, 7830, 4986]
0307142485	49	3	2	54	[1012, 4037, 8052, 4056, 6117, 5121, 3130, 6169, 3154, 6199, 7169, 2226, 2231, 2287, 1305, 7302, 9326, 6416, 7391, 9434, 7462, 9527, 3564, 8601, 7578, 6641, 1610, 7630, 1647, 7638, 5719, 2739, 8727, 6777, 8730, 4768, 6797, 768, 6830, 5818, 1820, 4884, 4935, 7926, 3967, 7935, 2987, 3987, 8992]	[4265, 1380, 5638]	[3347, 3970]
0738920762	24	1	6	31	[2012, 6016, 7028, 8045, 4078, 6096, 6160, 4181, 188, 9287, 4340, 9366, 5427, 3443, 4539, 9560, 3542, 8565, 1607, 7608, 3633, 674, 1942, 3949]	[5124]	[7055, 6282, 8318, 8335, 6847, 8841]
0780020685	4	4	11	19	[5092, 9538, 9892, 6950]	[5009, 7476, 9904, 3934]	[4047, 2174, 7251, 8305, 4305, 308, 4369, 3379, 8581, 3707, 931]
0780626699	0	1	5	6	[]	[3087]	[6011, 8194, 4417, 2438, 8951]
0780621964	3	10	53	66	[3137, 5221, 5612]	[3104, 4202, 200, 7323, 4450, 3454, 2613, 4789, 3904, 7915]	[1013, 7027, 65, 4073, 2090, 2130, 9132, 1156, 6193, 5201, 9220, 2255, 3247, 250, 2299, 2316, 1326, 9343, 2364, 1364, 9377, 7396, 5425, 9453, 5453, 3444, 6486, 464, 6499, 474, 5523, 5549, 5555, 3543, 4571, 1578, 4620, 7587, 9665, 5710, 4728, 6741, 3709, 8749, 5810, 4818, 4829, 3823, 4855, 4859, 1849, 8914, 993]
0780630874	3	4	12	19	[9018, 1066, 8616]	[7579, 9857, 5991, 1982]	[4011, 9123, 1147, 1213, 4264, 3300, 3355, 5534, 9555, 6640, 8739, 9987]
076701409X	2	4	0	6	[7011, 9066]	[4061, 6122, 1233, 9495]	[]
0767849493	3	6	47	56	[7670, 3841, 6890]	[9031, 9136, 267, 3532, 5621, 631]	[2013, 14, 9034, 9044, 1047, 58, 9173, 5205, 1204, 4211, 210, 6248, 5244, 1244, 2271, 9280, 5293, 5345, 2355, 3346, 1368, 8382, 468, 7468, 5510, 5521, 6547, 3537, 4590, 8586, 2614, 8619, 7639, 6733, 9774, 1740, 7762, 7803, 5936, 6972, 9967, 5972, 6999, 2960, 1952, 5996, 7988]
0767812778	0	1	1	2	[]	[12]	[8562]
0767823796	0	2	8	10	[]	[9632, 3738]	[3015, 7060, 5438, 4581, 9703, 7722, 4790, 5878]
0767018877	2	1	2	5	[9440, 9785]	[4903]	[5011, 7238]
0767836359	3	1	8	12	[5488, 5644, 2962]	[9858]	[1014, 8153, 9238, 3288, 352, 1639, 1777, 8915]
0780625218	1	1	3	5	[4621]	[1767]	[8013, 2648, 1898]
0780630890	8	9	20	37	[4442, 2481, 3514, 5624, 2659, 767, 6919, 3883]	[4012, 3043, 1330, 3607, 5694, 9742, 5766, 4810, 770]	[5126, 3160, 3172, 195, 2218, 3210, 260, 6391, 4409, 6473, 455, 3503, 511, 1698, 4732, 4748, 4798, 9890, 921, 2964]
0767802519	1	3	9	13	[5012]	[248, 2524, 5904]	[8094, 2129, 2343, 2407, 2681, 7659, 9792, 765, 5861]
0780630904	1	3	13	17	[7538]	[7214, 5272, 3261]	[9014, 9015, 9078, 8274, 289, 3399, 4449, 9658, 1661, 5815, 810, 7923, 2998]
0767014812	29	6	1	36	[6068, 91, 8126, 6137, 150, 8175, 5224, 208, 1425, 8440, 5448, 5482, 7454, 4501, 507, 1522, 6588, 4574, 6729, 8691, 6793, 4813, 8818, 3845, 4876, 3870, 6920, 8874, 1917]	[4013, 7020, 2055, 1309, 5384, 2620]	[5115]
0310274281	99	5	3	107	[7012, 8017, 9026, 2054, 8074, 4075, 6079, 3077, 2080, 8092, 98, 7100, 5110, 4106, 1120, 5127, 123, 2166, 4161, 9177, 8201, 9216, 2265, 2268, 8278, 7266, 8296, 7280, 6324, 5320, 6344, 2330, 3323, 1337, 8345, 339, 6371, 3353, 8380, 8395, 1427, 1429, 3442, 6485, 9475, 1464, 7448, 3463, 467, 6501, 6526, 7481, 7483, 4521, 3510, 4541, 5565, 9564, 4589, 4592, 2586, 6614, 1624, 9664, 1640, 1656, 8663, 8668, 9702, 3690, 1695, 1707, 6758, 5758, 2743, 1736, 8745, 9787, 7760, 7766, 3806, 9845, 8819, 3833, 1832, 9871, 4887, 6903, 9921, 8894, 5940, 2931, 9960, 5969, 4971, 9973, 3971, 8975, 999]	[8105, 8111, 9140, 143, 9169]	[4347, 9733, 3869]
0767821785	1	0	3	4	[8255]	[]	[6013, 2574, 5916]
0767005880	11	1	1	13	[8014, 7159, 5340, 1383, 4422, 418, 9544, 1562, 1653, 3954, 7999]	[7918]	[6213]
0764000829	9	6	11	26	[4249, 7248, 6326, 4564, 748, 3790, 6877, 2861, 3865]	[5406, 5454, 9558, 5657, 7662, 4830]	[2015, 5134, 1483, 6698, 3706, 700, 1752, 837, 2917, 3965, 2981]
0764006770	54	20	19	93	[1017, 3032, 2053, 3060, 8064, 4088, 2122, 4150, 4157, 5176, 2175, 4170, 9179, 7167, 7187, 7229, 9251, 7239, 8262, 5283, 268, 274, 8293, 5317, 4333, 4498, 4506, 541, 3567, 8584, 3576, 3578, 4613, 3596, 6636, 6638, 3611, 6674, 6678, 8658, 4718, 6746, 2722, 4745, 3727, 3788, 8821, 7808, 7819, 4922, 7859, 887, 7942, 3999]	[9051, 3080, 6103, 1235, 2340, 9425, 9492, 5585, 8636, 3665, 8670, 9737, 5793, 6813, 5804, 5805, 9817, 2832, 830, 8886]	[2057, 8080, 3105, 5128, 5292, 9316, 328, 2362, 1362, 9408, 8422, 1453, 3587, 5634, 1682, 3813, 2864, 1857, 1868]
0740328271	22	3	1	26	[4015, 4045, 4139, 2146, 1149, 1241, 5255, 4303, 9315, 9318, 3325, 4536, 1525, 7574, 5661, 4659, 3644, 3740, 6790, 9843, 9863, 821]	[3312, 4782, 980]	[591]
0782008348	2	1	10	13	[2236, 1663]	[836]	[9016, 7024, 3220, 5360, 2638, 4743, 2805, 843, 4893, 4947]
0783219857	2	3	22	27	[7414, 1484]	[6563, 688, 786]	[5014, 7091, 5109, 1197, 201, 222, 7228, 7288, 6354, 1353, 7364, 1403, 1405, 3415, 5484, 534, 5759, 9776, 2800, 894, 3958, 7998]
0767802624	6	2	4	12	[15, 9217, 4338, 5598, 5742, 920]	[1418, 4791]	[4030, 8551, 5727, 3998]
076780161X	73	19	9	101	[2016, 6023, 4041, 103, 9109, 1116, 7140, 1206, 244, 7286, 6330, 301, 6347, 1331, 2360, 3357, 8370, 6399, 4381, 7367, 4393, 5398, 7374, 5400, 7403, 6463, 436, 6551, 4549, 9563, 547, 9578, 1565, 9597, 6621, 4615, 7583, 2628, 3623, 628, 2653, 6684, 9689, 5697, 8677, 696, 9763, 4774, 5779, 9798, 5811, 6839, 3801, 3802, 1799, 8805, 797, 9854, 5859, 1837, 5889, 3881, 5917, 6931, 2894, 2901, 1899, 9958, 7901, 939, 7928, 961, 8980]	[4167, 5187, 1274, 5289, 1306, 5328, 9455, 1536, 2573, 9589, 9614, 7655, 1691, 7693, 4844, 5879, 4919, 5939, 7894]	[5081, 8090, 86, 1178, 7381, 2418, 6764, 3785, 2911]
0767812158	0	0	1	1	[]	[]	[7014]
0780621654	1	1	4	6	[6924]	[4016]	[9142, 3354, 3521, 3619]
0783117388	0	1	15	16	[]	[7422]	[1018, 1356, 368, 2470, 7558, 9704, 2726, 5771, 6849, 2819, 3853, 1865, 7863, 3897, 3948]
0767819403	1	1	1	3	[3376]	[651]	[9017]
0764006797	10	2	2	14	[3018, 7085, 6121, 6165, 8177, 579, 1644, 5762, 3900, 2938]	[3436, 8759]	[6114, 1325]
076785117X	2	1	18	21	[4017, 5250]	[8572]	[5062, 2182, 4188, 6226, 5314, 7312, 7347, 2412, 2665, 2674, 2695, 678, 9874, 5893, 2933, 8936, 965, 3991]
0738920525	29	4	3	36	[1020, 5045, 3054, 6085, 9090, 6099, 162, 3184, 7191, 3317, 8401, 1397, 4416, 5451, 4468, 3568, 7596, 4646, 8646, 673, 2731, 9782, 738, 1776, 5837, 8814, 3895, 2932, 954]	[3174, 8356, 3908, 2926]	[3457, 8634, 1813]
0780625528	1	1	3	5	[9814]	[1341]	[6017, 9178, 1876]
0767800761	45	6	5	56	[2018, 6044, 9049, 4053, 4054, 9076, 5140, 8143, 8189, 6230, 1223, 7220, 1253, 4276, 1280, 2284, 6305, 3305, 6360, 7333, 2392, 1399, 7406, 4471, 6488, 461, 1502, 4535, 7508, 4548, 6596, 4596, 2597, 7573, 5633, 4670, 664, 685, 827, 2904, 4938, 4962, 9966, 7902, 2988]	[7232, 8264, 369, 2400, 1613, 3807]	[6140, 220, 9344, 5402, 3714]
0767802497	20	13	24	57	[3023, 2025, 7035, 4058, 1103, 2164, 8179, 5195, 4316, 6482, 9476, 9485, 8486, 5558, 3608, 3676, 8719, 9870, 2871, 3946]	[4158, 4165, 9327, 6356, 2541, 563, 5680, 4704, 1731, 842, 1872, 5953, 5983]	[7016, 5027, 4065, 6074, 152, 5242, 9307, 8347, 356, 9390, 8464, 5494, 5498, 4554, 8603, 5626, 4712, 6765, 8754, 5816, 9823, 1835, 9901, 2907]
0780021088	1	1	6	8	[7099]	[4500]	[8019, 8141, 6153, 3260, 5459, 571]
0764001035	54	16	11	81	[1022, 26, 2103, 7121, 2133, 9141, 5153, 6182, 6208, 2221, 2239, 4243, 1277, 5288, 2308, 7289, 8316, 2323, 6413, 4435, 8449, 463, 473, 7463, 475, 503, 6554, 524, 6562, 8542, 5564, 6575, 9622, 1673, 9712, 8682, 7680, 695, 4752, 718, 8778, 2813, 2816, 1805, 6879, 1826, 3875, 5913, 4957, 1924, 5963, 1973, 8983, 1992]	[6032, 4082, 9102, 1136, 7147, 1166, 9207, 8352, 6370, 1430, 6450, 9480, 519, 7572, 6810, 2909]	[5073, 6092, 9221, 1243, 9262, 9415, 1488, 8768, 788, 5992, 953]
0780616561	0	2	14	16	[]	[207, 4953]	[5017, 6057, 1095, 3251, 3268, 1315, 2440, 2466, 3530, 2618, 9740, 4975, 7977, 7985]
0767827929	3	2	6	11	[4019, 7116, 1720]	[8294, 5783]	[8120, 3471, 7560, 8598, 1858, 8898]
076400638X	11	1	1	13	[7018, 1038, 9143, 9443, 3566, 4676, 668, 9808, 2829, 1956, 2976]	[104]	[3762]
0767802659	5	7	31	43	[4050, 8160, 4514, 8554, 5584]	[3022, 1359, 5458, 6660, 1645, 9938, 971]	[2026, 1037, 2058, 8093, 3092, 7109, 5129, 2134, 5197, 1208, 6303, 4285, 315, 7340, 351, 371, 2458, 7445, 3461, 3495, 1523, 3546, 9583, 7625, 7658, 2717, 7691, 739, 2795, 4895, 6998]
0783219695	3	2	9	14	[8020, 2147, 9236]	[6273, 6926]	[76, 1350, 1558, 1616, 5749, 1737, 4874, 1960, 1972]
0780619552	1	3	10	14	[2450]	[2201, 2288, 8961]	[18, 8023, 3073, 2246, 4494, 1486, 2585, 6784, 6817, 916]
0783103107	1	3	6	10	[5829]	[2346, 9503, 6521]	[9020, 29, 4510, 8736, 6859, 6955]
0780630858	8	7	33	48	[2042, 5130, 3255, 5315, 4358, 4430, 7418, 9685]	[5018, 2100, 1227, 2354, 3562, 2602, 857]	[4026, 69, 6087, 4103, 4107, 4126, 127, 2143, 5229, 7216, 9297, 349, 6381, 7353, 5449, 9451, 431, 4472, 7460, 8517, 8599, 5630, 7581, 9643, 7606, 657, 7689, 4809, 2812, 4894, 1935, 3961, 8958]
0780023080	2	1	4	7	[2184, 893]	[3191]	[4020, 1025, 273, 2352]
0767003357	64	10	19	93	[4068, 68, 1080, 4097, 3101, 2168, 8167, 4184, 3183, 4195, 6224, 4215, 7203, 3228, 2241, 7223, 3236, 4256, 251, 3253, 5271, 2273, 8285, 6306, 6312, 3358, 7393, 8419, 7407, 3435, 3453, 3482, 1494, 1510, 3513, 5559, 3536, 6593, 4580, 1579, 9626, 8620, 9657, 8635, 2663, 9681, 9688, 2678, 4737, 9760, 4784, 6811, 1770, 6853, 4889, 6939, 909, 8931, 1951, 9998, 2980, 1971, 3986, 990]	[9083, 9113, 1229, 6380, 8444, 7472, 8501, 3874, 2990, 3983]	[19, 9030, 1031, 6043, 3056, 3057, 5158, 8225, 9381, 9452, 7458, 1674, 5740, 7701, 5770, 3781, 1810, 7814, 8858]
0736915842	4	2	0	6	[9021, 6629, 9749, 6921]	[8341, 3941]	[]
0738921351	5	1	1	7	[8186, 6471, 8781, 9847, 3922]	[3024]	[5637]
0767827007	1	3	6	10	[8642]	[353, 5465, 8800]	[8022, 5030, 9406, 8452, 3462, 2676]
0767810864	1	1	3	5	[9022]	[8170]	[8231, 430, 3630]
0767010485	31	7	5	43	[5019, 1074, 75, 3107, 3144, 1177, 4175, 7221, 6265, 3266, 1300, 8315, 6400, 2391, 6419, 6438, 6451, 1470, 3466, 6527, 2639, 9700, 6752, 6785, 8771, 9832, 8834, 6905, 5938, 5956, 4999]	[3048, 7084, 9152, 5262, 7343, 9777, 5871]	[5257, 6317, 1411, 3550, 9903]
0767810880	2	3	5	10	[3026, 4891]	[7088, 3223, 4257]	[3067, 9131, 479, 683, 3756]
0780021096	0	0	5	5	[]	[]	[4021, 8228, 7452, 2774, 1861]
0767821408	0	0	8	8	[]	[]	[6022, 9037, 7118, 8302, 9471, 5577, 2806, 9876]
0764005537	18	6	3	27	[4022, 298, 9321, 4383, 2442, 8445, 3470, 4587, 6619, 2616, 4690, 7707, 4872, 7817, 4933, 907, 8969, 3985]	[9294, 3586, 4625, 4648, 6675, 2992]	[9303, 3682, 4833]
0767817680	3	2	11	16	[8149, 5445, 823]	[4048, 6851]	[7021, 5106, 6209, 4341, 2553, 9570, 6633, 9771, 6801, 752, 4940]
0767817478	5	9	50	64	[5020, 3204, 5423, 3599, 9676]	[4085, 4253, 8361, 8389, 393, 9496, 833, 1925, 963]	[5035, 6071, 4079, 3083, 9093, 4124, 128, 5167, 4186, 1202, 7207, 6251, 2286, 5306, 291, 2309, 4309, 8337, 9353, 341, 8368, 4372, 1372, 1379, 5418, 1410, 2431, 4437, 5497, 7477, 8524, 5556, 549, 6600, 8579, 2588, 3591, 4696, 7661, 2715, 3741, 5778, 769, 6843, 785, 3814, 2842, 2862, 1850, 8998]
0767000099	3	1	1	5	[3027, 8902, 994]	[7686]	[639]
0783219458	0	1	6	7	[]	[5705]	[7022, 7153, 1284, 6648, 666, 9848]
0307142477	2	0	4	6	[8025, 5091]	[]	[4052, 8372, 6433, 1802]
0780627784	1	3	5	9	[2666]	[5151, 4840, 2880]	[9025, 2120, 2213, 4343, 6401]
0767821955	1	2	9	12	[61]	[4871, 1852]	[1027, 7057, 7146, 1446, 2486, 9493, 531, 2849, 4915]
0783225261	0	1	4	5	[]	[781]	[4023, 5104, 9422, 5717]
0767836286	1	2	17	20	[3832]	[2443, 9855]	[3029, 5097, 7126, 4394, 4436, 1521, 9627, 5647, 4652, 5695, 8683, 6757, 9750, 727, 856, 9915, 7855]
0767805712	2	4	4	10	[8027, 7945]	[3112, 2748, 1757, 4815]	[2081, 5308, 1530, 5707]
0767804252	1	1	9	11	[3555]	[991]	[3030, 2165, 7255, 8290, 4487, 8498, 5529, 3548, 8784]
0767807588	0	0	7	7	[]	[]	[5023, 8087, 8196, 7202, 5426, 2924, 8934]
078322530X	0	2	6	8	[]	[4863, 4990]	[6026, 2078, 3276, 8897, 4948, 8987]
0767818075	0	1	3	4	[]	[6925]	[8028, 5044, 1420]
0307141985	4	1	0	5	[23, 9116, 7512, 2546]	[7263]	[]
0782005926	0	0	1	1	[]	[]	[9028]
0005119367	85	5	2	92	[24, 3034, 7032, 2033, 9045, 4044, 5052, 4049, 8054, 2095, 4108, 2126, 2131, 4130, 6166, 153, 8166, 4183, 7174, 8193, 5214, 5217, 4236, 3229, 8244, 238, 3240, 5267, 6290, 4274, 8280, 9282, 3282, 3283, 8308, 5334, 2336, 4351, 4378, 1393, 8403, 3387, 1402, 9427, 2444, 2449, 4540, 8538, 6569, 8552, 1551, 6605, 5606, 2605, 6631, 5628, 6655, 9645, 6743, 2720, 1718, 4757, 7703, 9770, 4786, 1747, 2775, 1758, 2793, 7759, 2835, 1841, 8863, 8875, 7856, 6949, 2925, 7886, 6980, 945, 7936, 7949, 3990, 8989, 996]	[6239, 6279, 494, 5730, 4793]	[6555, 7789]
0780651359	3	2	5	10	[9029, 539, 7906]	[1417, 6768]	[4083, 4089, 3127, 4180, 8249]
0780619250	1	3	24	28	[677]	[8150, 180, 1423]	[6028, 32, 2216, 7269, 7301, 8323, 7335, 3381, 8525, 2559, 4576, 7561, 1676, 2785, 5824, 4822, 1798, 5905, 7875, 6969, 9977, 9992, 1961, 7968]
0767814908	1	2	8	11	[3194]	[3705, 9859]	[6029, 7076, 1152, 1214, 7684, 4764, 8798, 2854]
0780022343	0	0	1	1	[]	[]	[2028]
0767816617	0	2	3	5	[]	[8133, 9668]	[6030, 5434, 3988]
0767802802	0	2	5	7	[]	[2399, 2784]	[1033, 1108, 6479, 465, 7615]
0783219806	1	1	4	6	[6908]	[1172]	[8032, 3207, 6708, 3834]
0767814932	0	0	4	4	[]	[]	[2030, 5747, 4885, 5989]
0767817443	2	9	37	48	[5132, 910]	[1072, 6247, 9432, 4448, 1546, 5787, 4812, 1916, 5990]	[28, 2040, 1046, 5053, 6055, 8068, 4095, 144, 3201, 2215, 7212, 5303, 9300, 3287, 2307, 3349, 6398, 4379, 3368, 2381, 405, 9500, 565, 8633, 3640, 2654, 1730, 2762, 6814, 9818, 9820, 9834, 1800, 796, 3918, 4998, 7958]
0767802454	24	12	25	61	[3037, 4036, 9052, 3070, 1098, 8125, 5150, 5156, 5237, 7313, 4368, 6418, 4403, 7444, 4573, 8612, 2705, 6735, 4783, 6880, 6944, 7914, 1954, 2972]	[7163, 7387, 6506, 2519, 5548, 9551, 1603, 7594, 8637, 7816, 7883, 8978]	[3040, 7149, 9250, 5342, 5367, 9409, 6426, 7436, 4495, 2527, 3515, 9547, 5588, 4607, 2617, 6656, 6706, 2713, 691, 3745, 6796, 8831, 9928, 6945, 905]
0783221487	6	10	57	73	[6081, 9094, 6120, 5663, 1759, 7919]	[3051, 8056, 4062, 4250, 9482, 5614, 598, 8684, 7738, 8948]	[8034, 5057, 6061, 102, 110, 5138, 5148, 8154, 6200, 9202, 1216, 209, 1263, 270, 3273, 2293, 8324, 7334, 7348, 6389, 1374, 6404, 4398, 2404, 2413, 9429, 433, 7433, 8462, 7451, 8509, 2526, 7503, 564, 6623, 4632, 5648, 5674, 5681, 5708, 2751, 5796, 6819, 4804, 2791, 780, 2815, 3812, 7784, 7805, 6891, 7837, 4924, 9955, 1920, 9961, 4979]
0780627806	1	8	9	18	[7457]	[3038, 109, 4205, 3311, 7441, 1581, 3700, 7975]	[8044, 5059, 6212, 8613, 7667, 5828, 8835, 3854, 845]
0780622642	7	5	24	36	[4029, 5373, 9398, 2426, 3613, 8705, 820]	[3186, 9319, 829, 5932, 9968]	[7036, 3098, 1143, 9231, 230, 9333, 7318, 6429, 3452, 8493, 4504, 5522, 7519, 5586, 1577, 599, 9637, 7626, 4680, 5767, 4776, 2769, 9838, 8808]
0780618548	1	0	5	6	[9504]	[]	[6034, 1104, 122, 2453, 484]
0782008062	0	1	3	4	[]	[4421]	[5032, 8667, 4931]
0783222955	0	2	9	11	[]	[1036, 8339]	[4127, 1148, 4353, 3369, 7549, 9600, 706, 5849, 1880]
0767844335	0	0	1	1	[]	[]	[5033]
0764005553	29	5	2	36	[4031, 40, 2061, 6139, 7150, 203, 3237, 266, 9312, 4314, 4440, 7497, 3557, 5646, 2636, 8639, 5731, 8696, 2718, 5788, 753, 3799, 8796, 5873, 5876, 9893, 6986, 4995, 7986]	[8055, 4098, 8211, 933, 8953]	[1542, 2557]
0767817737	0	0	5	5	[]	[]	[3039, 1258, 7342, 2809, 5836]
0767024427	1	1	4	6	[8363]	[4952]	[6035, 8077, 6645, 7798]
076780094X	14	12	24	50	[8037, 33, 3245, 283, 2311, 3364, 9540, 6612, 614, 3704, 6774, 8799, 6870, 1815]	[8043, 9043, 7097, 7231, 8506, 1651, 3776, 5827, 6918, 8866, 9990, 8973]	[8113, 5117, 113, 4141, 9158, 6216, 196, 6242, 9229, 6263, 6270, 7234, 264, 9289, 1291, 7410, 4441, 8473, 3496, 4529, 4598, 5679, 3656, 5812]
0780620135	0	1	2	3	[]	[1591]	[2035, 5668]
0767817672	2	2	1	5	[5485, 2846]	[4032, 9372]	[8217]
0782006795	1	2	4	7	[6038]	[8680, 7724]	[9464, 1497, 7751, 7890]
078322544X	1	4	11	16	[6749]	[34, 4074, 1132, 6342]	[7152, 3169, 3329, 7378, 723, 731, 2884, 2920, 951, 8968, 7956]
0310285569	5	0	0	5	[9038, 262, 1555, 606, 8651]	[]	[]
0783224443	0	0	2	2	[]	[]	[7038, 6910]
0767803329	0	2	3	5	[]	[1039, 2173]	[1239, 9259, 6550]
0780623274	0	0	6	6	[]	[]	[2038, 5504, 6556, 9582, 2700, 5725]
0767823931	0	0	2	2	[]	[]	[8040, 615]
0767801601	16	4	2	22	[36, 2075, 3081, 6175, 6327, 3338, 6440, 8706, 1711, 3734, 2778, 9819, 2876, 6962, 9999, 1991]	[8162, 3330, 7459, 9815]	[477, 9739]
078060718X	0	2	15	17	[]	[9059, 7590]	[1040, 1139, 1193, 9241, 1249, 8319, 3416, 3431, 3743, 3772, 5885, 5901, 3871, 6959, 7892]
0767802594	1	1	6	8	[1589]	[1252]	[4035, 8349, 6443, 9738, 3877, 7898]
0780020820	0	1	3	4	[]	[8867]	[7040, 5065, 5519]
0307142493	51	5	2	58	[1043, 1048, 2059, 2060, 1109, 6136, 7127, 5149, 6214, 8233, 8234, 3243, 271, 5316, 2315, 6361, 6384, 8377, 4380, 5390, 3426, 9467, 6514, 4517, 1512, 3504, 4552, 6567, 4563, 3541, 4599, 1575, 4606, 4617, 8638, 7629, 5688, 1657, 5696, 9708, 687, 3797, 4846, 2858, 8845, 9898, 6948, 6956, 8913, 4981, 956]	[1041, 5079, 9369, 1499, 2995]	[8283, 713]
0741100967	5	0	2	7	[7041, 1054, 7603, 8801, 9900]	[]	[145, 2554]
0780631234	3	0	10	13	[2505, 9539, 9917]	[]	[38, 7166, 8252, 7282, 6367, 2356, 2603, 9671, 6878, 7921]
0767016351	11	3	0	14	[3044, 8061, 1088, 3090, 6364, 7339, 2401, 7425, 6481, 8591, 6824]	[2350, 8360, 7752]	[]
0764005022	16	13	6	35	[2222, 5346, 9349, 8378, 9473, 2483, 9534, 8548, 581, 8621, 2656, 4700, 747, 5821, 1875, 3995]	[6042, 6155, 4162, 8176, 8258, 4324, 3493, 566, 5655, 6855, 4849, 3855, 9927]	[8130, 4155, 2675, 9753, 7771, 5949]
0767821548	1	1	6	8	[6613]	[3190]	[4038, 6156, 9308, 6405, 8505, 5613]
0307554066	11	1	6	18	[2067, 2430, 424, 458, 3609, 8675, 7718, 6845, 3885, 911, 1995]	[5088]	[1042, 5341, 2591, 3783, 3796, 3909]
0780619765	2	0	0	2	[9042, 5986]	[]	[]
0780607465	0	0	2	2	[]	[]	[7043, 6445]
078321958X	2	9	7	18	[1762, 3879]	[2043, 211, 6250, 4300, 4382, 444, 8495, 7563, 1833]	[6066, 9175, 3178, 3185, 8772, 5948, 4972]
0780626702	0	2	11	13	[]	[611, 7709]	[3046, 5231, 1230, 8484, 509, 3509, 9642, 6668, 4695, 3860, 8887]
0783211856	1	5	17	23	[5809]	[338, 1550, 5746, 881, 8982]	[8046, 6151, 8271, 6341, 1357, 385, 414, 9497, 559, 1567, 4605, 5607, 4671, 1675, 7799, 9911, 4936]
0780022300	2	3	12	17	[7812, 7867]	[6046, 9435, 2773]	[4178, 3271, 2540, 9577, 3553, 1671, 4710, 4755, 3820, 4985, 1953, 7972]
0783216084	2	4	11	17	[9311, 9948]	[3468, 804, 8857, 9913]	[1045, 1081, 7093, 8301, 4419, 5792, 2811, 8825, 3889, 3962, 978]
0767816234	1	5	11	17	[3659]	[2224, 6298, 5732, 5900, 8955]	[4042, 7068, 1082, 2111, 6643, 2635, 2742, 3760, 4868, 2889, 9943]
0780631277	0	1	9	10	[]	[6595]	[3047, 9162, 9360, 5664, 5750, 3739, 5842, 1814, 7860]
0782011098	0	0	3	3	[]	[]	[4043, 9799, 8904]
0738920339	10	0	0	10	[8048, 1164, 8365, 9550, 3641, 7643, 2787, 8777, 5925, 8916]	[]	[]
0767805739	2	0	8	10	[8404, 6803]	[]	[2046, 1165, 313, 2693, 6738, 7712, 2771, 6805]
0783113943	1	1	9	11	[6964]	[4899]	[8049, 4350, 6566, 4665, 4689, 5734, 2767, 737, 5790]
0780631641	1	1	10	12	[4630]	[7047]	[8079, 9228, 8267, 9305, 365, 3392, 7524, 3646, 822, 7959]
0767817656	0	2	12	14	[]	[3119, 8387]	[43, 1064, 2119, 5366, 8433, 6484, 1627, 3710, 9786, 4906, 918, 2994]
0767832302	0	3	14	17	[]	[3064, 514, 9722]	[6049, 50, 2208, 2219, 243, 6448, 4452, 1586, 7571, 9663, 7619, 4685, 3829, 4902]
0782008372	4	3	22	29	[292, 4410, 5528, 4570]	[276, 499, 7946]	[3049, 3074, 4193, 6363, 9357, 9385, 2386, 8411, 400, 410, 7427, 6570, 3534, 1561, 2644, 7609, 2689, 1738, 6820, 9962, 2971, 7957]
0767015533	26	5	1	32	[7048, 9053, 3088, 4115, 2142, 4169, 172, 6223, 7192, 5234, 5261, 1269, 319, 1377, 2394, 7423, 6536, 4528, 1580, 6711, 1728, 2802, 4904, 1931, 5985, 3963]	[1119, 6259, 8288, 7299, 1769]	[4954]
0783219571	2	1	1	4	[5050, 1126]	[2643]	[9156]
0767818040	0	1	10	11	[]	[5882]	[1050, 6052, 70, 6625, 2741, 758, 779, 7833, 2890, 3928]
0767816757	1	0	3	4	[7135]	[]	[2048, 7431, 2758]
0767827724	1	0	1	2	[45]	[]	[7664]
0782002064	2	3	5	10	[8438, 8536]	[8209, 9844, 3927]	[6050, 4110, 6243, 7278, 826]
0783224079	2	0	20	22	[9556, 5834]	[]	[1051, 8085, 7082, 108, 7115, 1130, 3280, 2427, 472, 5500, 2564, 562, 1582, 8593, 658, 7756, 2855, 4921, 9944, 5952]
0780630882	2	3	23	28	[2159, 7745]	[3072, 9193, 7267]	[1053, 9091, 3094, 1134, 4146, 4166, 4323, 5361, 1386, 6459, 6470, 7478, 9603, 1634, 6718, 3695, 4788, 4794, 3858, 7850, 904, 8965, 1999]
078062372X	0	0	4	4	[]	[]	[46, 7306, 1785, 2946]
0769720226	0	0	1	1	[]	[]	[2051]
0780021541	1	3	3	7	[4674]	[8053, 4973, 3972]	[8168, 2397, 4663]
0780020723	1	1	4	6	[47]	[8843]	[2193, 8503, 1571, 6690]
0783221312	1	2	4	7	[7177]	[7051, 529]	[8373, 3450, 7679, 4744]
0767827694	0	0	3	3	[]	[]	[3053, 7891, 957]
0783225199	2	2	10	14	[9054, 9205]	[7466, 8881]	[6231, 1324, 8485, 515, 8539, 9649, 9866, 5874, 4932, 5971]
0764004719	6	0	1	7	[3141, 9144, 9706, 1733, 4961, 5975]	[]	[5055]
0767800311	7	1	5	13	[5212, 3250, 8502, 560, 2599, 7777, 1944]	[6254]	[49, 9172, 4374, 7455, 3575]
0767839129	2	9	45	56	[2593, 6780]	[5082, 3225, 3419, 5608, 8597, 4725, 5791, 4883, 937]	[7053, 8076, 5076, 4105, 106, 2155, 166, 5192, 7171, 193, 6357, 7330, 2353, 2363, 9375, 3396, 8434, 6461, 2461, 6492, 8513, 528, 548, 580, 5627, 7621, 3652, 1649, 9692, 2697, 9726, 4746, 8711, 1714, 1723, 9825, 7783, 7806, 3838, 8861, 7876, 8911, 2967, 4993, 2973]
0783117531	0	0	1	1	[]	[]	[7054]
0764009265	9	5	5	19	[1075, 2074, 6335, 7400, 9707, 3872, 863, 5922, 886]	[1218, 3336, 8611, 5735, 860]	[9056, 4142, 5356, 4523, 3668]
0783116330	0	1	1	2	[]	[7233]	[6056]
0767830520	1	0	19	20	[7242]	[]	[1060, 82, 6112, 115, 6180, 4197, 2238, 6293, 7276, 2369, 7510, 9586, 4656, 5658, 8645, 3737, 4766, 6858, 7940]
0780022041	0	0	2	2	[]	[]	[3058, 3126]
0738921475	12	0	0	12	[5058, 53, 1073, 74, 5108, 9115, 1124, 135, 7665, 4836, 869, 8917]	[]	[]
0740318934	19	1	7	27	[52, 3093, 132, 8188, 8198, 4228, 7294, 3370, 6469, 449, 505, 7499, 569, 5689, 5814, 2845, 8852, 6936, 8889]	[3422]	[9267, 6685, 7694, 9754, 2750, 777, 7822]
0767025105	4	3	2	9	[4057, 9431, 8769, 7802]	[9330, 3500, 5582]	[7173, 3465]
0780622537	1	3	10	14	[3775]	[174, 8310, 2334]	[3059, 1068, 3152, 8197, 5503, 5652, 4719, 9735, 3747, 3842]
0563412879	25	3	2	30	[54, 8127, 3125, 3148, 2161, 2186, 2192, 4203, 2317, 1321, 391, 6545, 545, 9619, 9639, 4664, 3660, 3687, 2711, 9781, 5863, 2859, 867, 3892, 1928]	[4101, 8369, 1863]	[1821, 5886]
0764002589	3	3	0	6	[3343, 5920, 8950]	[5061, 3171, 1700]	[]
0767847539	0	0	1	1	[]	[]	[3061]
0767832485	2	1	13	16	[3341, 8487]	[2908]	[6062, 3161, 2176, 3200, 4308, 2331, 9447, 3489, 5662, 6789, 8752, 3915, 5957]
0767018672	18	0	1	19	[2062, 2073, 2179, 177, 8203, 2234, 9322, 6543, 540, 7546, 9673, 8665, 7668, 8694, 4739, 7711, 1879, 9923]	[]	[2830]
0767026225	7	3	1	11	[1065, 1270, 7254, 3473, 8729, 803, 4958]	[5137, 1701, 2799]	[2936]
0767018702	6	0	0	6	[4060, 2395, 6472, 4555, 9633, 750]	[]	[]
0764007440	39	21	4	64	[3078, 5100, 7123, 8146, 5196, 5203, 6219, 7195, 3211, 2261, 1275, 7275, 1354, 4362, 9371, 373, 8406, 4408, 2435, 3446, 8460, 8528, 9592, 6654, 2641, 6667, 635, 8656, 8685, 8713, 3827, 5866, 7866, 2918, 6961, 1908, 3950, 1949, 949]	[9061, 3114, 130, 2153, 147, 4176, 6249, 7210, 7235, 6299, 9380, 7379, 4402, 1520, 8569, 2625, 4668, 6731, 2740, 9864, 888]	[6292, 4318, 7395, 2783]
0780629868	0	2	5	7	[]	[3153, 4385]	[6063, 6188, 6602, 7720, 8785]
0783218842	0	0	3	3	[]	[]	[2063, 6189, 2533]
0783115202	0	2	13	15	[]	[4901, 2949]	[8065, 6183, 8205, 235, 9306, 6359, 7432, 4562, 9769, 4770, 3789, 5846, 8939]
0780621948	1	1	1	3	[7062]	[2361]	[427]
0780631684	2	4	23	29	[8608, 8701]	[5208, 2228, 1498, 2694]	[5063, 1085, 7225, 8299, 7279, 7291, 4327, 9416, 3406, 4429, 5475, 2551, 8673, 6755, 3774, 4892, 858, 2900, 3940, 941, 943, 946, 8988]
0767817761	0	3	0	3	[]	[9062, 2138, 9937]	[]
0783218915	0	1	2	3	[]	[4591]	[7063, 2508]
0783114893	0	1	8	9	[]	[4946]	[1067, 5331, 1612, 2763, 9821, 1793, 9916, 6988]
0767819586	4	6	18	28	[5094, 1298, 314, 3508]	[2235, 8415, 558, 9613, 5620, 7829]	[4063, 6295, 275, 7316, 8455, 5461, 9494, 6510, 3479, 1490, 6539, 1537, 3621, 9795, 2808, 789, 9951, 7997]
0767836324	0	3	16	19	[]	[6194, 3643, 3713]	[2065, 2102, 8124, 119, 6220, 9284, 8343, 7341, 3658, 6712, 8792, 1851, 848, 1864, 1906, 8900]
076781083X	0	1	4	5	[]	[7533]	[4064, 8496, 6603, 4882]
0780022823	1	2	3	6	[62]	[5388, 5890]	[3113, 6511, 6875]
0780625609	0	2	1	3	[]	[9064, 714]	[7095]
0783115377	0	1	7	8	[]	[6233]	[6067, 9445, 452, 8492, 712, 5869, 1968]
0767825411	2	2	15	19	[9695, 4853]	[9170, 1174]	[1069, 1137, 5142, 9363, 4479, 3535, 7535, 6601, 3598, 6770, 9828, 7775, 7809, 1912, 7992]
0783214243	1	1	11	13	[4287]	[3075]	[8070, 7096, 4147, 9400, 381, 508, 1689, 9794, 8765, 4879, 2874]
0767809262	3	0	9	12	[9254, 7744, 8826]	[]	[63, 6106, 1283, 4320, 1339, 5419, 497, 7648, 8695]
0780020693	0	0	3	3	[]	[]	[7067, 2496, 2898]
0767806239	0	3	8	11	[]	[4067, 6532, 3703]	[5225, 4391, 9656, 4673, 3649, 9751, 7815, 932]
0615274641	3	3	17	23	[8071, 8107, 9276]	[1189, 5319, 701]	[5131, 1176, 7338, 5429, 8425, 2445, 9461, 5509, 4515, 8580, 3603, 1660, 3726, 2790, 6917, 891, 3953]
0767853636	4	9	20	33	[5249, 4289, 5309, 5393]	[80, 8101, 2149, 359, 5469, 1476, 9489, 5777, 6974]	[5069, 9098, 4179, 305, 4352, 2365, 9382, 3388, 443, 9490, 1568, 5698, 1677, 675, 8735, 7749, 8820, 7824, 3937, 8995]
0780628799	0	8	23	31	[]	[1160, 7213, 8340, 6358, 1400, 587, 3657, 9953]	[8072, 6082, 2092, 7143, 1158, 5171, 8190, 7193, 9234, 5304, 7298, 4354, 3409, 2522, 9618, 9669, 5700, 9718, 5769, 2766, 735, 1754, 9852]
0738920363	20	1	3	24	[6083, 2156, 8289, 7303, 9324, 1333, 532, 6583, 2623, 1643, 1655, 1750, 8812, 5868, 8830, 1900, 9945, 6975, 7927, 8999]	[1950]	[2070, 9086, 2520]
0767817486	0	0	8	8	[]	[]	[4070, 1513, 5545, 5589, 6662, 8763, 8872, 1903]
0780021592	1	0	3	4	[8073]	[]	[2110, 8259, 7332]
0767825519	0	0	1	1	[]	[]	[3069]
0780614097	1	0	4	5	[2899]	[]	[67, 8463, 7602, 715]
0782010679	1	0	5	6	[1211]	[]	[7070, 4214, 8468, 3516, 3933]
0615837891	7	2	1	10	[7072, 8100, 4526, 2719, 8738, 4835, 9849]	[1308, 7763]	[7599]
0780621573	0	2	32	34	[]	[1114, 1825]	[7073, 3097, 5154, 141, 4281, 4282, 4315, 4322, 9345, 7352, 1387, 8420, 6456, 5517, 4525, 6540, 4534, 6597, 9599, 1587, 707, 8716, 9756, 8724, 9767, 4806, 3784, 6848, 4873, 6896, 3947, 2959]
0780626478	1	2	6	9	[8078]	[6352, 574]	[6301, 9391, 8504, 7557, 4865, 2850]
0767826728	3	5	24	32	[4123, 5239, 8243]	[8226, 3742, 1831, 1871, 9907]	[6080, 2116, 9124, 1140, 4140, 3150, 3205, 257, 3295, 5375, 4396, 6435, 2439, 2460, 8476, 536, 6620, 3617, 7754, 6897, 3882, 7905, 9981, 8960]
0780623711	1	0	6	7	[2724]	[]	[5078, 4219, 7264, 8625, 4762, 8921]
0780631528	1	5	6	12	[3294]	[320, 3610, 9698, 693, 4827]	[7074, 4246, 1347, 8575, 8605, 6720]
0738900370	16	1	2	19	[72, 8081, 9137, 8172, 9225, 8254, 2321, 1452, 4553, 5587, 5602, 5629, 2781, 1827, 8899, 8932]	[2302]	[2099, 7522]
0780622588	1	1	9	11	[7595]	[6395]	[7075, 2185, 9189, 1201, 6339, 4485, 3748, 3787, 2983]
0767811410	1	1	14	16	[4729]	[7719]	[2077, 4138, 3263, 6369, 8400, 2433, 3424, 9652, 2660, 4792, 6850, 4848, 2844, 9970]
076781777X	0	0	7	7	[]	[]	[4080, 1084, 5085, 375, 3715, 2745, 5830]
0767817745	1	1	1	3	[4081]	[4470]	[5096]
0780021967	2	5	3	10	[4143, 8895]	[4255, 1328, 9337, 4850, 2912]	[7077, 5447, 4622]
0767835069	0	0	4	4	[]	[]	[2079, 9290, 6432, 882]
078201061X	0	4	4	8	[]	[1115, 6337, 388, 9882]	[7078, 6252, 3278, 8494]
0740321757	5	1	2	8	[1163, 4206, 3326, 6682, 2699]	[6786]	[9081, 8984]
0767023447	4	1	0	5	[3082, 4114, 3202, 1432]	[5572]	[]
0767812417	0	2	5	7	[]	[5552, 2915]	[78, 2097, 4608, 5685, 7879]
0767026977	10	3	0	13	[5083, 9199, 6348, 425, 5526, 6565, 730, 3777, 6844, 884]	[9203, 396, 9878]	[]
0783114176	0	2	0	2	[]	[7079, 7741]	[]
0780020464	1	0	0	1	[3084]	[]	[]
0780618068	0	1	7	8	[]	[426]	[7080, 8136, 9513, 8614, 7593, 686, 967]
0764005448	2	6	2	10	[6271, 3579]	[2148, 1251, 1588, 4629, 8836, 9950]	[1086, 8690]
0767817648	2	1	2	5	[285, 6624]	[5745]	[4086, 5486]
0767827813	0	0	1	1	[]	[]	[1087]
0767804236	0	1	2	3	[]	[6970]	[6093, 8312]
0780021061	0	1	1	2	[]	[1112]	[7083]
0740319183	10	1	1	12	[7417, 428, 8560, 7633, 1742, 6833, 9824, 5848, 7882, 3935]	[4661]	[6094]
0767081455	23	0	2	25	[6095, 138, 1153, 7155, 9196, 5277, 332, 5439, 8482, 9502, 4519, 3518, 3558, 3583, 7617, 4681, 4753, 1734, 5776, 5784, 6911, 2986, 1998]	[]	[7354, 2580]
0780023099	0	0	1	1	[]	[]	[9089]
0783215126	1	0	5	6	[279]	[]	[7087, 1094, 4713, 6782, 8927]
0738920967	16	4	3	23	[7092, 124, 9171, 2187, 9215, 306, 7320, 9395, 397, 1480, 6632, 6754, 2794, 1812, 952, 972]	[5093, 5401, 7851, 8943]	[7517, 7695, 1948]
0767802683	0	1	10	11	[]	[8615]	[90, 9151, 2200, 3193, 4230, 2562, 6658, 708, 934, 976]
0780623746	0	2	8	10	[]	[4092, 8522]	[1209, 1316, 7390, 2451, 4636, 1705, 790, 885]
0767811437	0	1	6	7	[]	[3678]	[7090, 5112, 2158, 2312, 5379, 8922]
0780619951	2	3	15	20	[2786, 851]	[9184, 5228, 4446]	[6102, 96, 2124, 6258, 3373, 2497, 8568, 4583, 680, 6773, 2780, 8851, 3893, 979, 7974]
0767818059	1	1	3	5	[3605]	[4721]	[1096, 7634, 763]
0767837371	0	0	6	6	[]	[]	[1097, 3270, 6386, 5463, 5774, 7910]
076701135X	7	4	0	11	[5098, 2135, 8409, 6740, 4824, 1873, 3925]	[5269, 8489, 2568, 8574]	[]
0767837991	1	1	2	4	[9444]	[2098]	[4234, 3792]
0780612906	0	2	9	11	[]	[9701, 4777]	[4094, 336, 523, 626, 9807, 4847, 8838, 8896, 2963]
0783222068	0	2	3	5	[]	[5099, 3945]	[9183, 437, 755]
076781505X	2	4	9	15	[1102, 1615]	[7382, 5716, 8839, 7847]	[7105, 5160, 4164, 2247, 7487, 5789, 8755, 5853, 5897]
0767826701	1	0	2	3	[2101]	[]	[2390, 6653]
0767821467	0	0	3	3	[]	[]	[4099, 1192, 4254]
0780620860	0	1	1	2	[]	[1508]	[2104]
0767817710	1	2	17	20	[9829]	[5185, 3906]	[8104, 6131, 2127, 9272, 5330, 8383, 6496, 2539, 533, 2566, 4610, 6677, 2652, 2776, 8762, 1787, 2891]
0780619412	3	0	9	12	[4235, 3227, 9647]	[]	[99, 4116, 9198, 9257, 7470, 9541, 7677, 9813, 4926]
0767811100	1	1	9	11	[1817]	[8458]	[100, 176, 8653, 8712, 8726, 7858, 6951, 3917, 3932]
0767839145	0	0	4	4	[]	[]	[9106, 4122, 8152, 4724]
0783219660	0	1	3	4	[]	[9204]	[2108, 7681, 6775]
0780023420	0	2	2	4	[]	[1110, 774]	[9487, 4918]
0780022882	0	0	2	2	[]	[]	[9107, 3959]
0780621980	2	3	16	21	[5856, 7920]	[3520, 4711, 1790]	[5111, 6268, 7304, 8353, 4357, 4512, 6585, 6590, 3708, 2789, 8810, 7791, 5883, 6904, 2975, 1997]
0767835980	1	0	4	5	[4259]	[]	[7103, 1415, 5604, 6686]
0739040375	4	2	0	6	[4543, 8758, 1889, 4968]	[4109, 5906]	[]
0783112750	0	2	5	7	[]	[8662, 5785]	[5116, 5133, 4293, 604, 6727]
0783219598	0	1	3	4	[]	[8355]	[2115, 4201, 9717]
0767834860	1	1	9	11	[8557]	[535]	[4112, 186, 2285, 8441, 3469, 3628, 8686, 5748, 4751]
0767853946	1	1	12	14	[5928]	[4611]	[4113, 4291, 5339, 5351, 9410, 4412, 6594, 5677, 4708, 5728, 9980, 7982]
0767815963	2	0	4	6	[1118, 5763]	[]	[7157, 5302, 5566, 6960]
0767827686	0	1	2	3	[]	[2376]	[5120, 9335]
0782006752	0	0	10	10	[]	[]	[112, 191, 1228, 6323, 5312, 3432, 469, 480, 6609, 2735]
0780022386	0	4	8	12	[]	[6124, 4229, 3258, 871]	[9243, 5324, 3585, 3661, 2826, 2877, 2929, 1977]
078062856X	1	4	14	19	[2532]	[1296, 1652, 1708, 8817]	[9118, 6383, 7376, 3451, 7467, 2582, 7624, 9675, 5756, 8807, 2834, 1922, 8985, 986]
0767847563	0	0	3	3	[]	[]	[5122, 6408, 743]
0783223609	0	2	6	8	[]	[4117, 9258]	[1276, 1375, 7501, 9672, 3902, 4955]
0783113145	1	0	2	3	[4118]	[]	[6186, 8250]
0782006809	1	1	6	8	[5371]	[1371]	[2121, 6162, 3180, 7180, 9549, 9946]
076781956X	1	3	15	19	[4332]	[2212, 4299, 6914]	[5123, 3129, 3134, 7247, 6294, 282, 7337, 1509, 4560, 4603, 7568, 6689, 7698, 6812, 7848]
078062162X	0	1	5	6	[]	[8394]	[9119, 7183, 5207, 8421, 6937]
0782007058	0	0	1	1	[]	[]	[1125]
0780621638	0	1	6	7	[]	[2310]	[6128, 4386, 4427, 1471, 2777, 924]
0780629450	3	1	16	20	[2525, 1926, 3964]	[7321]	[5125, 5193, 1407, 7401, 2447, 5460, 1474, 2530, 2549, 2685, 5761, 5780, 5835, 2910, 948, 1981]
0767824407	1	1	4	6	[3420]	[1127]	[6129, 6517, 2708, 5753]
0780018664	0	0	4	4	[]	[]	[1128, 5184, 4601, 6618]
0767817664	1	0	3	4	[3551]	[]	[9121, 5172, 1930]
0783112572	1	2	4	7	[1129]	[1434, 624]	[9263, 344, 7439, 9932]
0767849981	1	1	1	3	[5945]	[2406]	[3122]
0767821610	0	0	1	1	[]	[]	[7120]
0739600443	1	2	2	5	[1133]	[6206, 4593]	[8181, 1768]
0780630459	1	3	10	14	[5365]	[3123, 7162, 2657]	[7215, 8247, 6269, 4387, 4532, 1597, 9670, 9721, 7845, 2930]
0767817729	3	1	7	11	[3170, 2266, 3269]	[9765]	[9125, 8326, 5355, 4415, 9507, 1694, 9896]
0767809335	1	1	5	7	[2132]	[7620]	[217, 4280, 7350, 9376, 4916]
0780627024	1	3	7	11	[9460]	[9128, 3492, 2543]	[9154, 340, 7375, 2436, 1468, 9598, 3674]
0767835093	1	0	5	6	[7482]	[]	[5135, 9210, 6255, 3624, 9983]
0767818067	0	1	2	3	[]	[1527]	[6141, 5563]
0782009980	1	1	3	5	[9129]	[3380]	[2151, 7496, 6779]
0780023013	1	0	0	1	[4133]	[]	[]
0767810848	0	1	2	3	[]	[2457]	[3128, 2631]
0767806743	0	0	3	3	[]	[]	[1138, 1505, 2922]
0780627849	0	0	4	4	[]	[]	[4136, 5374, 9512, 8518]
0780022181	2	3	21	26	[5246, 3800]	[9579, 9719, 4715]	[5141, 5162, 5218, 9239, 5329, 7355, 481, 8527, 5639, 9674, 9716, 6772, 8766, 4803, 3837, 840, 2888, 877, 1966, 1970, 7955]
0767835174	1	2	1	4	[7645]	[1414, 2690]	[3133]
0767831322	0	1	6	7	[]	[5580]	[6152, 321, 8446, 9609, 3648, 9959]
0767810856	1	1	3	5	[3993]	[585]	[1142, 9481, 2984]
0767827716	0	1	10	11	[]	[3417]	[6154, 8216, 1288, 4325, 1451, 2506, 6577, 561, 9659, 8946]
0767821807	0	2	4	6	[]	[2144, 155]	[3175, 3187, 3316, 1818]
0767809726	0	1	1	2	[]	[6868]	[2145]
0782007015	2	1	5	8	[280, 3554]	[3913]	[3138, 5333, 3606, 1604, 2870]
0767827775	2	1	3	6	[6564, 8707]	[8718]	[1146, 239, 2765]
0780629159	1	1	8	10	[4538]	[9223]	[4144, 2183, 4310, 9419, 408, 3501, 6626, 7854]
0780626109	1	2	4	7	[8761]	[4466, 7616]	[9145, 7443, 1685, 7800]
0780020502	0	0	2	2	[]	[]	[7137, 9872]
0767812174	0	2	3	5	[]	[9146, 335]	[9266, 8427, 8794]
0783212771	0	0	3	3	[]	[]	[3146, 8780, 1789]
0780618831	0	1	0	1	[]	[8155]	[]
0764005383	7	2	0	9	[3147, 148, 7168, 1295, 9298, 5709, 2977]	[6309, 3981]	[]
0767809378	0	0	7	7	[]	[]	[3149, 6422, 9531, 8622, 9678, 3880, 3910]
0780020847	0	1	12	13	[]	[1595]	[4148, 4220, 5479, 1529, 5553, 3642, 9744, 4742, 3822, 1909, 914, 2956]
0767825489	1	1	2	4	[1154]	[9646]	[2706, 2779]
0767815335	2	2	9	13	[9192, 416]	[1168, 3969]	[4152, 7209, 6320, 1514, 5546, 550, 4722, 8751, 1886]
0782009123	1	2	4	7	[5597]	[4377, 6541]	[8161, 1187, 1478, 638]
0780619331	1	2	2	5	[9736]	[6322, 6864]	[7144, 2374]
0780629876	1	0	2	3	[4765]	[]	[5163, 7490]
0767812131	0	1	1	2	[]	[5944]	[151]
0767824032	1	0	1	2	[2163]	[]	[9244]
0615115187	24	2	0	26	[8163, 4247, 2254, 7309, 9401, 441, 504, 1554, 3561, 2579, 9650, 4867, 7810, 6906, 1860, 2878, 9910, 6933, 7868, 1910, 9971, 8937, 8957, 3997]	[1684, 7723]	[]
0783116934	1	0	1	2	[9159]	[]	[4298]
0769403468	0	0	4	4	[]	[]	[1161, 5554, 7651, 7688]
0764127861	3	0	4	7	[3156, 4317, 5739]	[]	[322, 8576, 601, 8779]
0738921947	6	1	0	7	[5169, 5274, 8442, 8644, 2721, 6907]	[4860]	[]
0738900672	12	3	1	16	[5170, 3219, 2237, 6289, 1395, 4454, 2474, 8475, 3570, 8647, 649, 897]	[1721, 3903, 2916]	[6794]
0782011284	0	2	0	2	[]	[9164, 5248]	[]
0783223099	3	0	1	4	[9165, 2295, 5954]	[]	[6744]
0767813464	0	0	1	1	[]	[]	[9168]
0780621603	1	1	4	6	[2801]	[2172]	[5412, 6680, 7895, 4969]
0780020634	1	3	3	7	[2672]	[8173, 8398, 377]	[1704, 8901, 6968]
0783200544	0	3	7	10	[]	[3167, 7518, 7967]	[2197, 2278, 3352, 2423, 9572, 7636, 8908]
0783204914	0	1	4	5	[]	[9679]	[5178, 5352, 2668, 4800]
0767821742	0	0	5	5	[]	[]	[163, 7196, 8631, 1755, 3794]
0780022270	0	1	2	3	[]	[9694]	[4168, 8848]
0767801865	5	0	0	5	[6192, 2180, 1533, 9575, 7631]	[]	[]
0767806808	0	0	3	3	[]	[]	[3168, 7506, 1888]
0783221983	3	3	5	11	[7158, 378, 8661]	[4269, 3265, 5919]	[8297, 5512, 3839, 7904, 1979]
0767847431	0	0	1	1	[]	[]	[2178]
0767819446	1	1	7	9	[7200]	[9561]	[7161, 1215, 8241, 7287, 1664, 5736, 6889]
0767827651	2	1	2	5	[681, 8909]	[170]	[1431, 8470]
0767827678	0	0	2	2	[]	[]	[1181, 3764]
0767009711	3	1	1	5	[5531, 8567, 3815]	[4177]	[7582]
0783221088	2	4	9	15	[602, 4633]	[5189, 3215, 9526, 6644]	[215, 252, 3359, 5505, 2510, 5538, 4811, 832, 1883]
078322172X	0	1	12	13	[]	[7683]	[6203, 9197, 3218, 3400, 3498, 2650, 654, 2704, 5800, 8770, 4845, 8847]
0767811070	0	0	2	2	[]	[]	[3176, 9875]
0783113196	0	0	6	6	[]	[]	[3177, 4453, 8479, 7527, 2682, 7708]
0767824008	1	1	6	8	[2188]	[2264]	[4185, 8227, 1301, 3597, 616, 9682]
0767804929	0	0	8	8	[]	[]	[6210, 9288, 284, 6425, 3527, 6732, 740, 8790]
0783222475	1	1	3	5	[8947]	[959]	[9191, 808, 1878]
0782010539	0	0	1	1	[]	[]	[7176]
0738919012	3	2	0	5	[1194, 6635, 5754]	[3580, 2935]	[]
0783114664	0	1	1	2	[]	[181]	[977]
0783111037	0	0	1	1	[]	[]	[4189]
0767840895	0	1	1	2	[]	[7179]	[6529]
0738921467	7	0	0	7	[183, 7261, 2531, 3629, 1679, 1717, 5860]	[]	[]
0783112645	0	0	1	1	[]	[]	[5202]
0767814037	0	0	3	3	[]	[]	[2198, 1390, 5455]
0783210973	1	0	3	4	[7412]	[]	[7182, 2282, 386]
0783107986	0	2	6	8	[]	[4609, 7818]	[9201, 4344, 576, 8748, 9853, 1964]
0767815718	0	1	2	3	[]	[5877]	[6222, 9905]
0767808673	1	4	18	23	[6616]	[2205, 1286, 4614, 593]	[4218, 4271, 454, 2469, 5491, 1492, 9509, 501, 3505, 3589, 9661, 2692, 9747, 6788, 759, 776, 3804, 4896]
0783115008	0	1	4	5	[]	[8204]	[4238, 8357, 8655, 5752]
076620748X	3	2	1	6	[9314, 3876, 7877]	[3192, 1487]	[2523]
0780622545	2	6	20	28	[7461, 617]	[237, 9283, 8309, 7300, 2492, 4624]	[2206, 2225, 9351, 4397, 379, 9418, 7426, 5496, 4537, 2552, 4623, 612, 7612, 7647, 6892, 5891, 8864, 876, 1933, 4987]
076783917X	0	1	3	4	[]	[8783]	[6225, 8534, 9574]
0780608372	2	0	9	11	[4462, 6929]	[]	[190, 7237, 9367, 8465, 466, 1481, 2516, 1600, 5942]
0783114885	0	2	4	6	[]	[3472, 3828]	[5210, 7743, 6860, 5980]
076780922X	0	0	5	5	[]	[]	[5211, 4530, 9571, 7652, 4956]
0780022076	0	1	0	1	[]	[7190]	[]
0782006930	0	1	5	6	[]	[4866]	[6232, 8256, 1473, 3545, 6846]
0767832566	0	1	3	4	[]	[8720]	[8212, 8531, 9879]
0767827740	0	1	2	3	[]	[7198]	[9417, 846]
0780625277	1	3	5	9	[9899]	[7199, 3249, 890]	[7277, 2398, 3382, 841, 9920]
0782006787	0	0	2	2	[]	[]	[202, 5625]
0780022084	0	0	3	3	[]	[]	[204, 278, 4897]
078322253X	0	2	2	4	[]	[4697, 2896]	[8220, 7773]
0780625129	0	2	11	13	[]	[5714, 850]	[1221, 9235, 4505, 2502, 2517, 552, 2567, 2578, 6829, 6888, 9888]
0783219105	0	4	5	9	[]	[3540, 7642, 6736, 6993]	[8223, 5502, 636, 644, 2852]
0780622030	0	0	2	2	[]	[]	[3212, 4349]
0767847121	0	0	1	1	[]	[]	[7208]
0510539610	5	1	0	6	[5236, 432, 2484, 7610, 9894]	[9914]	[]
0783219172	1	1	7	9	[6716]	[4683]	[7211, 5394, 2594, 5840, 4977, 7961, 7993]
0782010059	0	2	1	3	[]	[1234, 7776]	[7900]
0767802551	0	0	8	8	[]	[]	[4231, 5280, 5336, 5470, 5495, 1592, 2626, 2978]
0780623614	1	3	14	18	[4336]	[1236, 4769, 8737]	[2291, 2313, 6366, 5377, 3391, 7553, 5693, 4730, 1724, 5822, 6867, 2833, 9922, 6982]
0783116918	0	0	2	2	[]	[]	[7217, 9822]
078311611X	1	0	1	2	[702]	[]	[227]
0780627792	0	1	2	3	[]	[3683]	[2240, 3333]
076782170X	0	1	6	7	[]	[8741]	[1242, 4297, 2669, 6869, 968, 8993]
0767801814	6	1	0	7	[3345, 4401, 3476, 2499, 2867, 3968]	[2242]	[]
078061755X	0	1	1	2	[]	[7449]	[7222]
0738920770	15	2	4	21	[3231, 6267, 7322, 7336, 7372, 3395, 8432, 417, 6467, 1469, 9800, 9827, 1941, 7941, 3994]	[2258, 866]	[5325, 5456, 1507, 9693]
0783225253	2	2	2	6	[1576, 1939]	[3365, 6973]	[2248, 1601]
0780022629	0	0	5	5	[]	[]	[2249, 3281, 7369, 7765, 7795]
0767827791	2	2	8	12	[3293, 7611]	[5254, 6984]	[4277, 7434, 439, 7509, 2548, 7534, 6688, 4880]
0767857178	0	1	1	2	[]	[2250]	[8878]
0780021134	2	1	3	6	[3238, 2615]	[6707]	[9788, 8880, 4988]
0780620801	0	0	3	3	[]	[]	[2252, 5656, 4740]
0769721125	0	0	1	1	[]	[]	[5258]
0780627776	1	2	6	9	[4444]	[4666, 1983]	[1256, 6315, 3563, 9641, 6967, 5974]
0767809254	0	1	4	5	[]	[4908]	[246, 3691, 5773, 4949]
0767850661	1	0	4	5	[2259]	[]	[6280, 329, 1348, 7548]
0780622170	0	0	1	1	[]	[]	[4262]
0767802535	1	1	4	6	[960]	[5764]	[8265, 4451, 1710, 8822]
0767810872	0	0	6	6	[]	[]	[4263, 2515, 7580, 633, 2703, 3850]
0783219733	0	0	2	2	[]	[]	[7246, 5799]
0783225539	0	0	1	1	[]	[]	[254]
0767809246	1	0	6	7	[407]	[]	[3254, 4473, 3478, 8607, 8853, 3905]
0780022491	1	1	4	6	[6701]	[8405]	[4266, 3421, 8472, 7589]
078062775X	0	0	3	3	[]	[]	[5273, 3308, 3622]
0767805267	1	1	4	6	[259]	[4284]	[8510, 2560, 9886, 7841]
0767847571	0	1	2	3	[]	[2274]	[2609, 1629]
0780621611	0	0	1	1	[]	[]	[9277]
0782011179	1	0	0	1	[7256]	[]	[]
0780023447	0	0	2	2	[]	[]	[3262, 3975]
0767850246	0	1	7	8	[]	[9278]	[3332, 5404, 483, 9524, 5540, 556, 6762]
0780613856	0	0	4	4	[]	[]	[7260, 6578, 6671, 4941]
0783217471	1	1	0	2	[1454]	[4279]	[]
0780613678	0	0	2	2	[]	[]	[8282, 7899]
0767819624	0	0	3	3	[]	[]	[6300, 3386, 6885]
0780021312	1	0	1	2	[5285]	[]	[1401]
0767802578	1	1	6	8	[1913]	[6856]	[1281, 4321, 7377, 6737, 1779, 4862]
0780628519	1	2	7	10	[7500]	[3385, 2737]	[5286, 3315, 1352, 2633, 3680, 6781, 7764]
0767818172	1	2	0	3	[1795]	[9285, 9610]	[]
0780622375	1	0	1	2	[6304]	[]	[676]
0783201672	0	1	8	9	[]	[3272]	[6489, 8497, 8561, 8585, 1642, 7732, 854, 6928]
078060959X	1	0	6	7	[307]	[]	[3274, 6373, 9520, 7613, 5794, 7916]
0783200870	1	0	2	3	[5775]	[]	[1287, 2498]
0782007848	0	0	2	2	[]	[]	[1289, 732]
076783822X	2	1	2	5	[404, 5440]	[2999]	[7271, 9885]
0783222149	0	2	3	5	[]	[619, 1807]	[4288, 7366, 4565]
078322365X	1	0	4	5	[6512]	[]	[5296, 9364, 7399, 6702]
0783222424	0	0	2	2	[]	[]	[8295, 8700]
0773386777	2	2	1	5	[6699, 9741]	[9296, 5660]	[435]
0782010660	0	1	4	5	[]	[4364]	[4294, 1467, 7774, 1958]
0767851013	0	2	8	10	[]	[7469, 1753]	[1297, 4433, 3447, 1658, 2788, 1774, 3824, 1987]
0767821505	0	0	5	5	[]	[]	[7284, 8516, 5594, 4694, 1874]
0767823354	0	2	2	4	[]	[3393, 9477]	[6319, 1504]
0767812743	0	0	5	5	[]	[]	[2305, 346, 8676, 1844, 8976]
0783114222	0	2	0	2	[]	[1304, 8566]	[]
078200847X	0	0	1	1	[]	[]	[4306]
0780627717	0	0	3	3	[]	[]	[1313, 9608, 998]
078062338X	0	0	1	1	[]	[]	[6336]
0767835948	0	2	7	9	[]	[7550, 1897]	[8322, 6535, 9559, 5573, 2664, 815, 1989]
0767814924	0	0	1	1	[]	[]	[3309]
0780020200	0	4	3	7	[]	[311, 1349, 4456, 4841]	[1496, 2528, 8997]
0780625358	0	0	1	1	[]	[]	[8327]
0780627830	0	0	2	2	[]	[]	[7307, 4484]
078062565X	1	1	4	6	[835]	[9331]	[6437, 4672, 8855, 7971]
0769720323	0	0	1	1	[]	[]	[1329]
0767817699	0	0	6	6	[]	[]	[318, 3351, 3672, 3689, 1709, 9908]
0767811097	0	1	13	14	[]	[746]	[323, 6362, 5350, 6519, 496, 7486, 9546, 594, 3631, 3669, 733, 5819, 4991]
0780021118	0	1	2	3	[]	[1549]	[5348, 7770]
0767819594	1	2	5	8	[756]	[9347, 5711]	[6478, 595, 6791, 7797, 831]
0780020901	0	0	2	2	[]	[]	[334, 7559]
0783215517	0	0	1	1	[]	[]	[7328]
0767819462	0	0	4	4	[]	[]	[337, 7699, 729, 1745]
0780622383	0	0	2	2	[]	[]	[8354, 2598]
0767811054	1	0	0	1	[3342]	[]	[]
0780627865	0	1	0	1	[]	[8367]	[]
0780623789	0	1	1	2	[]	[5368]	[3398]
0783214235	0	2	1	3	[]	[1363, 8604]	[6546]
0780613880	0	0	2	2	[]	[]	[6392, 725]
0767819764	0	1	4	5	[]	[4917]	[5382, 8428, 4628, 7675]
0767819179	0	1	1	2	[]	[6953]	[2382]
0783217048	0	1	3	4	[]	[8795]	[5396, 3480, 5961]
0767808460	0	0	1	1	[]	[]	[7373]
0783218923	1	0	0	1	[4399]	[]	[]
0780623215	0	0	1	1	[]	[]	[5407]
0780623258	0	0	3	3	[]	[]	[5410, 1823, 9994]
0767804325	0	0	1	1	[]	[]	[9412]
0767821718	1	0	3	4	[919]	[]	[1404, 9705, 7825]
0780630548	0	0	1	1	[]	[]	[7388]
078321541X	0	0	1	1	[]	[]	[2414]
0767818083	0	0	2	2	[]	[]	[2415, 7938]
0780023145	0	0	1	1	[]	[]	[1413]
0783105533	1	0	3	4	[878]	[]	[7402, 4814, 2902]
0782006760	0	0	3	3	[]	[]	[6439, 6584, 8919]
0782008364	0	1	5	6	[]	[3408]	[6513, 6628, 3692, 1764, 813]
0780619536	0	0	1	1	[]	[]	[6441]
0780627873	0	1	3	4	[]	[5798]	[9433, 538, 6946]
076780337X	0	1	2	3	[]	[6446]	[1466, 1988]
0783116640	1	0	1	2	[4461]	[]	[9438]
0767812115	0	1	2	3	[]	[516]	[2437, 8942]
0767823729	2	0	1	3	[2747, 6916]	[]	[1433]
0783112610	1	1	0	2	[9997]	[7421]	[]
0767832248	0	0	1	1	[]	[]	[3427]
0783208227	1	0	1	2	[4447]	[]	[5520]
0767804309	1	0	1	2	[5450]	[]	[879]
0783114583	0	2	1	3	[]	[1566, 3614]	[6462]
0767809688	0	0	2	2	[]	[]	[5457, 4905]
0783213638	0	0	1	1	[]	[]	[4459]
0780623088	0	0	1	1	[]	[]	[1449]
0783116926	0	1	2	3	[]	[7435]	[7504, 5720]
0767802616	0	1	4	5	[]	[7438]	[772, 5832, 9833, 3952]
0780624378	0	3	0	3	[]	[6477, 6806, 1986]	[]
0767818105	0	0	2	2	[]	[]	[447, 7785]
0767833600	0	1	1	2	[]	[8461]	[8553]
0767018907	3	1	4	8	[6483, 5795, 928]	[457]	[7704, 7726, 6863, 5960]
0767840135	0	0	1	1	[]	[]	[2467]
0767850823	0	1	1	2	[]	[2472]	[8483]
0780623592	0	0	2	2	[]	[]	[5480, 1544]
0783222548	0	0	2	2	[]	[]	[6500, 5701]
0767855000	0	0	4	4	[]	[]	[4491, 6568, 3718, 9952]
076785344X	1	0	1	2	[1791]	[]	[1485]
0767819381	0	0	2	2	[]	[]	[2493, 3782]
0767856449	0	0	1	1	[]	[]	[4502]
076784730X	0	1	0	1	[]	[1495]	[]
078062579X	0	0	1	1	[]	[]	[5514]
0783116896	0	0	1	1	[]	[]	[9511]
0780020227	0	1	5	6	[]	[2792]	[9518, 8545, 9696, 2754, 6996]
0780620364	0	0	1	1	[]	[]	[8512]
0783217358	1	1	0	2	[3979]	[2514]	[]
0783225482	1	1	1	3	[6537]	[4527]	[4604]
0783215088	1	1	0	2	[2744]	[5539]	[]
0780021940	0	0	3	3	[]	[]	[2535, 572, 5642]
0767815122	1	0	0	1	[525]	[]	[]
0780021932	0	1	0	1	[]	[4551]	[]
0767847202	0	1	1	2	[]	[8558]	[5557]
0767827635	0	0	1	1	[]	[]	[5560]
078200833X	0	1	1	2	[]	[2649]	[7530]
0783110871	0	0	2	2	[]	[]	[2565, 3754]
076784436X	0	0	1	1	[]	[]	[1552]
0783225504	1	0	2	3	[5854]	[]	[1559, 5997]
0780626516	0	0	1	1	[]	[]	[7542]
0780625803	0	0	1	1	[]	[]	[1570]
0769720994	0	0	1	1	[]	[]	[9596]
0783114907	0	0	2	2	[]	[]	[6611, 8606]
078311494X	0	0	1	1	[]	[]	[2592]
0767825616	0	1	2	3	[]	[1996]	[9604, 3647]
0782011276	0	0	1	1	[]	[]	[7570]
0780020731	0	1	4	5	[]	[3728]	[2606, 623, 3757, 985]
0767811429	0	0	4	4	[]	[]	[1590, 7663, 8802, 8854]
0780621549	0	0	3	3	[]	[]	[5617, 1666, 8674]
0767830806	0	0	1	1	[]	[]	[9621]
0780023536	0	0	1	1	[]	[]	[600]
0780021185	0	0	2	2	[]	[]	[8617, 4773]
0780630149	0	0	1	1	[]	[]	[3620]
0780662911	0	0	2	2	[]	[]	[618, 7947]
0767827902	0	1	2	3	[]	[3626]	[9690, 922]
0783213115	0	0	1	1	[]	[]	[7605]
0780622278	0	1	0	1	[]	[625]	[]
0783219148	0	1	0	1	[]	[2645]	[]
0780620879	0	0	1	1	[]	[]	[8643]
0767850262	0	0	2	2	[]	[]	[1638, 641]
0769720382	1	0	0	1	[645]	[]	[]
0783114338	0	1	1	2	[]	[647]	[9758]
0767844386	0	0	1	1	[]	[]	[3655]
0780619439	0	1	1	2	[]	[6836]	[5683]
0780022122	0	0	1	1	[]	[]	[6700]
0780020707	0	0	1	1	[]	[]	[2680]
0767819543	0	0	2	2	[]	[]	[1667, 9816]
0780018648	0	1	0	1	[]	[3670]	[]
0783114532	0	1	0	1	[]	[4707]	[]
0783114729	0	0	2	2	[]	[]	[711, 9793]
0767807693	0	0	1	1	[]	[]	[2736]
0767812166	1	0	1	2	[7944]	[]	[3732]
0780020618	0	1	1	2	[]	[719]	[8743]
076784257X	1	0	1	2	[1727]	[]	[9887]
076781214X	0	1	2	3	[]	[8732]	[2764, 2927]
0783116780	0	1	1	2	[]	[2753]	[8933]
0783217390	0	0	4	4	[]	[]	[1739, 4799, 4828, 3857]
0767821483	0	0	1	1	[]	[]	[9783]
0773386726	0	0	1	1	[]	[]	[1744]
0783104146	0	0	1	1	[]	[]	[6798]
0783224060	0	0	1	1	[]	[]	[8750]
0780020987	0	0	1	1	[]	[]	[8756]
0767809548	0	1	2	3	[]	[9991]	[9801, 3977]
076782184X	0	1	0	1	[]	[9804]	[]
0783116764	0	1	0	1	[]	[7747]	[]
0767837363	0	1	0	1	[]	[1775]	[]
0783217536	0	0	1	1	[]	[]	[5820]
0773345019	0	0	2	2	[]	[]	[6838, 8945]
0780020804	0	0	1	1	[]	[]	[5826]
0780631323	0	1	0	1	[]	[4834]	[]
0767804341	0	0	2	2	[]	[]	[9839, 8924]
076780760X	1	0	1	2	[792]	[]	[5946]
0780607287	0	0	2	2	[]	[]	[5845, 4982]
0767816641	0	1	1	2	[]	[6943]	[9846]
0780620372	0	0	1	1	[]	[]	[9860]
0780021045	1	0	1	2	[2969]	[]	[6884]
0780029410	0	0	1	1	[]	[]	[9868]
0767819470	1	0	1	2	[4875]	[]	[987]
076780676X	0	0	1	1	[]	[]	[1842]
0767821920	0	0	1	1	[]	[]	[5881]
0767807596	0	0	1	1	[]	[]	[6900]
0780022319	0	0	1	1	[]	[]	[1856]
0783114877	0	0	1	1	[]	[]	[3862]
0767812387	0	1	0	1	[]	[2875]	[]
0780630106	0	0	1	1	[]	[]	[868]
0783224788	0	0	1	1	[]	[]	[8885]
0783207425	0	0	1	1	[]	[]	[9939]
078002320X	0	0	1	1	[]	[]	[7881]
0780627857	0	0	1	1	[]	[]	[2928]
0767848535	0	0	1	1	[]	[]	[4960]
0780630068	0	0	1	1	[]	[]	[8920]
0783205945	1	1	0	2	[9979]	[929]	[]
0783224885	1	0	0	1	[2966]	[]	[]
0780019164	0	0	1	1	[]	[]	[7930]
0780625773	0	0	1	1	[]	[]	[4997]
0780020715	0	0	1	1	[]	[]	[974]
