	positive	neutral	negative	total	positive_list	neutral_list	negative_list
0005019281	93	8	8	109	[10, 4034, 8029, 7030, 6036, 2050, 5068, 1093, 71, 93, 3086, 9134, 6113, 7111, 9166, 4216, 178, 4245, 9232, 9237, 9240, 245, 6207, 9265, 7197, 3208, 3216, 7219, 8239, 8261, 9350, 3277, 8273, 8276, 2339, 9373, 5476, 5530, 5535, 9454, 7351, 460, 8384, 8392, 1621, 7380, 1632, 1648, 527, 2509, 8436, 1699, 2536, 4761, 4763, 8480, 5802, 1784, 1824, 656, 7521, 3559, 5892, 8559, 4927, 9752, 4951, 9755, 2714, 5994, 5998, 9803, 800, 9867, 7656, 3702, 3724, 7687, 3733, 2841, 8702, 900, 6759, 7714, 9947, 2879, 7733, 2893, 7750, 7769, 6874, 3921, 6977]	[1015, 3164, 3402, 1828, 870, 8833, 7911, 7953]	[9000, 1232, 4420, 9424, 5808, 5935, 3697, 3808]
0764007211	63	8	8	79	[5000, 6014, 8038, 8047, 9074, 6101, 4217, 167, 8142, 9206, 1260, 3165, 6238, 9301, 5389, 5422, 4438, 3289, 364, 3321, 9423, 3339, 1538, 7329, 9462, 4588, 9469, 9474, 9506, 9525, 1665, 6457, 1722, 2544, 634, 2619, 1848, 6557, 1859, 4898, 7539, 4925, 5929, 4943, 2710, 6630, 2723, 9805, 6681, 3686, 6713, 862, 3712, 8734, 938, 7740, 6822, 2941, 6835, 2943, 7787, 6966, 8926]	[4024, 4119, 7297, 1574, 8474, 4805, 7700, 2955]	[6138, 5704, 3634, 7716, 9949, 8938, 7922, 7925]
0764005693	46	17	9	72	[4000, 3005, 4027, 3036, 7039, 84, 8098, 4190, 5188, 3121, 168, 9213, 5270, 1290, 229, 5326, 5338, 7236, 5405, 342, 8332, 2473, 3449, 3455, 1719, 7479, 6542, 5895, 1893, 6606, 2688, 745, 2749, 828, 6696, 9891, 6728, 8721, 3770, 2919, 7768, 7780, 7792, 8828, 3873, 8892]	[25, 4272, 9273, 9275, 5399, 5416, 3331, 9428, 6393, 1726, 8490, 3522, 643, 1921, 4980, 2733, 2851]	[4007, 4267, 9299, 3348, 5684, 5973, 778, 8649, 8963]
076780192X	227	60	23	310	[0, 1006, 3006, 2008, 6010, 7013, 3025, 6031, 1056, 7033, 7034, 6037, 44, 3045, 9057, 57, 9063, 5087, 8058, 2072, 5103, 2085, 94, 4129, 1135, 5144, 5146, 4153, 1155, 1159, 1169, 1170, 8103, 7107, 8112, 2137, 2150, 6134, 7129, 2162, 4224, 5227, 5230, 1231, 9188, 7141, 1240, 4248, 4251, 6161, 9218, 7165, 9224, 223, 6195, 9246, 5321, 1319, 8213, 8218, 5354, 4367, 3244, 7243, 7245, 4423, 4425, 1412, 5431, 2319, 8272, 6287, 1436, 1440, 1442, 1443, 1459, 1463, 4481, 6316, 6325, 390, 8313, 5511, 3335, 2387, 6351, 8334, 8344, 3363, 451, 6379, 3372, 9479, 1585, 7360, 1602, 3394, 8391, 4651, 2465, 500, 4662, 6424, 8413, 2488, 526, 5686, 9548, 5690, 4701, 7415, 537, 9557, 7420, 8431, 551, 5712, 9569, 4726, 5722, 5724, 7437, 1712, 2529, 9587, 4754, 5755, 9601, 4771, 8466, 4780, 7464, 7465, 3491, 9623, 6503, 2572, 7471, 9635, 5807, 6518, 4819, 2590, 630, 4825, 4831, 1797, 4832, 5823, 2601, 5831, 4842, 4843, 4852, 1819, 5847, 1829, 4864, 5857, 9686, 5858, 4869, 1840, 6553, 1843, 2629, 8537, 1854, 5880, 5884, 6579, 699, 2662, 9732, 4928, 2670, 5923, 5930, 9746, 3592, 3604, 2698, 4974, 8602, 1976, 9811, 8627, 802, 805, 3667, 816, 3685, 2798, 2804, 3717, 2820, 2823, 8687, 889, 7690, 8710, 7702, 9936, 915, 9941, 3758, 927, 935, 942, 2887, 9984, 7746, 2905, 6816, 6821, 6831, 3825, 2954, 7823, 8840, 7838, 8859, 6930, 8928, 6985, 7937]	[1000, 1024, 1044, 1058, 2068, 3096, 2167, 216, 1278, 9226, 4296, 6201, 9245, 247, 3209, 7205, 5372, 5376, 2279, 9329, 6276, 5430, 366, 9421, 1564, 6376, 7357, 3377, 1631, 3414, 6427, 583, 9615, 2577, 1772, 9651, 8500, 7495, 7511, 5867, 3556, 4912, 6634, 3632, 8623, 3666, 6730, 898, 3752, 2892, 7739, 6837, 6866, 7835, 3929, 7909, 3957, 7913, 7948, 7989]	[7069, 3106, 2160, 5247, 7194, 3279, 6311, 5487, 3344, 6368, 1706, 9581, 4807, 7493, 7536, 7544, 7575, 749, 1947, 9802, 6657, 2951, 7834]
0780622561	1	0	5	6	[1150]	[]	[2000, 9023, 6157, 9585, 9912]
0767819454	0	0	12	12	[]	[]	[5001, 6051, 7145, 8199, 4370, 6256, 5428, 5596, 5599, 9636, 2948, 7842]
0738919039	14	2	2	18	[6000, 1091, 4163, 8110, 1264, 286, 8338, 5632, 1633, 4686, 9713, 6719, 6721, 7979]	[179, 8652]	[8541, 6726]
0767801962	17	15	8	40	[3000, 5008, 5042, 5064, 160, 189, 2357, 9439, 8399, 9530, 2550, 597, 8526, 5984, 9809, 3939, 8954]	[55, 6053, 1122, 1145, 221, 6234, 2283, 6291, 9359, 2329, 4723, 1715, 762, 2729, 801]	[5223, 7218, 384, 7361, 589, 3547, 9935, 7885]
0780019172	0	0	3	3	[]	[]	[7000, 4209, 1569]
0310263662	320	308	331	959	[1008, 7010, 3010, 1021, 3013, 5021, 5022, 5024, 3017, 3020, 8024, 5040, 30, 7026, 4046, 1057, 8036, 3041, 2056, 59, 5084, 6054, 2066, 5095, 4111, 6072, 2084, 89, 6073, 6075, 4120, 2089, 9096, 4132, 3085, 8083, 9108, 3091, 114, 6098, 5157, 8096, 9133, 9138, 7108, 3115, 4196, 8117, 1195, 1198, 8121, 7122, 6132, 5216, 171, 9182, 6150, 5232, 4244, 1248, 3157, 197, 9209, 7154, 6171, 2196, 9219, 8169, 9222, 5284, 226, 7172, 4295, 6196, 7181, 4311, 7184, 8192, 1310, 7189, 9269, 8208, 5337, 4348, 4371, 2267, 3233, 9302, 8232, 4384, 2276, 2277, 5383, 3242, 4392, 4407, 1394, 4413, 3256, 5409, 5413, 4426, 5420, 4432, 6281, 1424, 1428, 7262, 9352, 6286, 1438, 4460, 1448, 358, 361, 9374, 8291, 9378, 7285, 9384, 4490, 9386, 9387, 6314, 5489, 9403, 389, 3318, 6328, 1500, 6333, 8320, 6340, 406, 1517, 8325, 412, 9430, 413, 419, 4557, 1535, 9442, 2402, 9448, 2409, 2410, 4577, 5569, 5575, 5576, 2420, 8359, 9470, 6378, 2428, 5591, 9478, 3375, 7356, 8371, 5603, 5605, 5616, 1611, 488, 5631, 2459, 8393, 5640, 9515, 8402, 2477, 7398, 5667, 9537, 5676, 4706, 3438, 8430, 3441, 4716, 2511, 9566, 2513, 7428, 9573, 4731, 9580, 3458, 3464, 4750, 9591, 2537, 575, 9593, 9594, 4759, 582, 4767, 1735, 7453, 1741, 5768, 6493, 3484, 6495, 3488, 3494, 1763, 8488, 6515, 1782, 4816, 7485, 7494, 9662, 1804, 3523, 1809, 1822, 4856, 7507, 6548, 1834, 5862, 8533, 7520, 4881, 4888, 8540, 7526, 3565, 6574, 8555, 5910, 5918, 1901, 4934, 3590, 4942, 1911, 5934, 5950, 6610, 8583, 741, 5962, 1943, 5967, 6622, 8595, 5981, 2716, 4992, 764, 6639, 8609, 1980, 9806, 2738, 2756, 806, 812, 2768, 9856, 2782, 839, 7650, 849, 7657, 853, 8671, 6709, 9884, 6715, 7672, 7674, 3725, 2831, 896, 2848, 901, 902, 3749, 8717, 3761, 8731, 3767, 3769, 7729, 944, 7734, 966, 3795, 7755, 3805, 982, 6834, 3861, 7820, 7821, 8849, 7836, 8860, 7862, 7880, 3931, 6941, 3944, 7929, 7931, 3980, 8952, 8970, 8977, 8979, 7960, 8994, 7970]	[8000, 4001, 5006, 3004, 5007, 8004, 9011, 5016, 13, 3014, 21, 22, 6021, 9033, 37, 8031, 9040, 4059, 3042, 1070, 9060, 7049, 8051, 9065, 9068, 4090, 4093, 6059, 3062, 7059, 8062, 79, 1105, 2083, 1123, 8075, 1131, 8084, 1141, 116, 9120, 125, 7102, 2128, 136, 3111, 5180, 2136, 4198, 5198, 156, 6130, 5204, 161, 5209, 8129, 5213, 7130, 5226, 6149, 7139, 3151, 9190, 2177, 187, 5243, 6163, 7151, 2191, 7160, 4278, 8171, 5282, 2217, 2220, 1302, 9247, 8191, 242, 6205, 1332, 4346, 6228, 9281, 5358, 5363, 288, 3234, 1367, 2275, 5378, 9304, 1373, 297, 7230, 303, 4400, 8246, 4405, 5408, 5415, 1409, 7250, 4428, 6275, 9338, 2314, 8266, 5437, 6285, 2320, 2322, 5441, 7265, 343, 9355, 2326, 1447, 9365, 5467, 1461, 5471, 2344, 5472, 9383, 372, 4493, 3314, 4513, 399, 9414, 7310, 4531, 9420, 7314, 7315, 6343, 4542, 3337, 411, 7319, 4559, 4568, 4575, 9457, 440, 3360, 5571, 3361, 1560, 4597, 2432, 4616, 7363, 3389, 2452, 1608, 5623, 4635, 2455, 2456, 6407, 491, 1623, 3403, 4654, 6414, 9532, 5666, 9535, 2485, 4691, 7413, 1678, 3439, 4714, 1686, 1687, 6452, 6453, 2512, 2521, 8443, 4741, 1716, 5741, 6475, 4758, 1732, 588, 4781, 3483, 596, 3486, 4787, 3487, 6498, 1786, 6520, 9648, 5813, 6523, 632, 7498, 8514, 5839, 5841, 1830, 9687, 6552, 7515, 670, 1846, 4878, 2630, 6558, 6561, 2637, 2642, 5902, 4913, 5903, 9724, 2658, 6581, 2667, 7552, 716, 7556, 8571, 2691, 8582, 9761, 4964, 5955, 5959, 8588, 1957, 5976, 3625, 766, 9790, 1978, 3638, 2734, 9826, 2759, 8641, 3671, 3675, 6687, 3684, 6693, 6694, 3694, 847, 3696, 9877, 6724, 8689, 3730, 7692, 2847, 6747, 8709, 908, 6771, 9954, 6783, 947, 2897, 8753, 962, 2906, 9993, 3798, 983, 6818, 995, 997, 2940, 3836, 2958, 7793, 3843, 3846, 6862, 8816, 8824, 2997, 3891, 6899, 7846, 6922, 7865, 7870, 6934, 7878, 3936, 8903, 7896, 6963, 6965, 3966, 8949, 7963, 7987, 7995]	[5, 7004, 7006, 2009, 9019, 3019, 6024, 2029, 8026, 9036, 4051, 9041, 42, 8039, 2047, 6045, 5070, 66, 5089, 9069, 8057, 7058, 9079, 3065, 1106, 8066, 7065, 1121, 5119, 2091, 3076, 6088, 107, 3089, 1144, 4145, 5145, 8091, 3095, 121, 4159, 2117, 9126, 3103, 5166, 6111, 134, 7104, 3109, 6116, 139, 140, 5186, 8114, 4191, 146, 9153, 4200, 154, 4207, 4208, 1205, 6135, 169, 4221, 3136, 8135, 5222, 6144, 7133, 9180, 9186, 4242, 185, 5253, 8158, 3166, 6173, 1273, 2204, 4283, 2209, 3179, 5294, 232, 4302, 3188, 234, 3189, 9242, 2230, 2233, 5318, 5323, 6217, 4334, 1327, 5347, 5349, 1345, 3221, 2257, 9293, 3232, 1366, 2272, 8230, 3239, 9309, 300, 5392, 304, 309, 9320, 1398, 317, 4418, 1406, 8260, 6284, 5443, 5446, 9361, 2333, 355, 9370, 2341, 4477, 5468, 2342, 9379, 6307, 367, 4488, 2349, 6313, 7296, 8307, 4511, 2372, 9413, 3328, 5527, 409, 1524, 8330, 1528, 420, 1534, 7326, 1539, 3350, 4578, 4579, 9458, 9466, 3367, 8358, 9472, 8366, 7359, 7362, 4619, 9488, 8375, 5609, 3383, 4626, 7368, 2448, 5619, 5622, 6402, 8388, 1622, 8396, 9516, 502, 4658, 2471, 3412, 7392, 2478, 513, 2480, 5669, 8417, 2494, 3434, 9552, 6442, 8424, 2500, 9553, 5703, 6455, 7430, 9576, 4735, 4738, 5744, 1729, 3477, 1743, 4785, 5781, 9629, 4801, 7474, 621, 1781, 7484, 3511, 4838, 642, 6533, 1811, 5844, 4854, 9683, 1838, 665, 2624, 5864, 5865, 8532, 3549, 1853, 7528, 1866, 9711, 5899, 703, 5911, 3581, 6589, 4929, 5927, 4945, 724, 6604, 4959, 5951, 2696, 8587, 9768, 4976, 4978, 9780, 6627, 1959, 5993, 5995, 1975, 2727, 3637, 6647, 793, 2746, 8629, 6663, 6669, 2761, 9840, 819, 8650, 3681, 3688, 6695, 6703, 9873, 8669, 9880, 2807, 2818, 874, 9902, 2824, 3722, 9909, 2837, 6739, 3735, 9924, 3746, 913, 2863, 925, 8725, 926, 6769, 9957, 6776, 9964, 3786, 9982, 8757, 3791, 9989, 7748, 9995, 973, 6826, 3826, 7781, 2952, 2953, 3835, 7790, 8804, 7794, 8811, 6861, 8823, 8829, 6887, 8856, 7852, 3907, 7864, 3923, 7887, 6947, 3960, 6991, 3982, 7939, 8962, 3996, 7976, 7983]
0718000315	41	10	5	56	[9001, 7061, 9088, 9103, 7086, 8095, 1179, 4213, 1217, 1220, 9187, 5259, 7156, 5279, 5287, 224, 5299, 4342, 8229, 9336, 6278, 2368, 1547, 438, 4679, 5670, 7411, 4775, 5896, 694, 3574, 5915, 5926, 7565, 9766, 9778, 3662, 6683, 8703, 3773, 6987]	[8030, 5067, 2093, 5478, 1482, 4669, 9542, 7567, 3793, 3840]	[5113, 1190, 8182, 5702, 970]
0767821599	1	1	4	6	[653]	[7324]	[1, 9046, 6260, 6981]
0767020553	33	3	5	41	[2001, 9012, 4039, 2109, 158, 1224, 8139, 1279, 5300, 253, 256, 4457, 7292, 2375, 4585, 4639, 5645, 5782, 3506, 6538, 9680, 3552, 689, 4907, 6591, 2702, 787, 7637, 7758, 6932, 6942, 6958, 8981]	[9084, 1317, 5592]	[2031, 3246, 5490, 8397, 7873]
076400459X	21	5	1	27	[1001, 7031, 6172, 4268, 236, 9260, 5411, 2303, 4439, 5501, 4520, 2576, 2627, 709, 3612, 2732, 794, 9836, 6692, 2886, 8890]	[2244, 8423, 8803, 7796, 8967]	[1292]
0767819438	3	7	25	35	[1212, 1672, 7586]	[7042, 294, 470, 4640, 5765, 2712, 9963]	[5002, 7015, 7019, 1111, 2086, 3102, 8108, 9139, 9174, 2211, 4330, 345, 6296, 1455, 4516, 5508, 1596, 3410, 3571, 7551, 2684, 9842, 7635, 2869, 2913]
0764006584	21	11	6	38	[5010, 16, 31, 4066, 4121, 1191, 6125, 6127, 5307, 1419, 5462, 9456, 450, 1599, 4647, 2475, 1654, 4817, 2611, 9728, 2942]	[1059, 5074, 73, 1257, 5290, 3285, 2489, 5691, 3437, 9628, 3593]	[3001, 5152, 8118, 864, 3914, 6978]
0764001027	7	2	4	13	[7001, 2256, 9595, 2589, 2621, 6742, 7857]	[2359, 2393]	[362, 5600, 7735, 7952]
0767821513	0	0	6	6	[]	[]	[8001, 1250, 7514, 667, 8699, 3852]
0767803434	0	3	17	20	[]	[7064, 2195, 8837]	[6001, 1078, 8131, 225, 6262, 7258, 6374, 7383, 498, 8450, 4939, 728, 8589, 873, 2991, 8832, 7990]
078062369X	3	8	12	23	[9002, 422, 1650]	[2069, 2232, 8248, 9332, 3512, 9743, 9929, 3856]	[5072, 9122, 7106, 1450, 8328, 5543, 3459, 1713, 4779, 9677, 6756, 2903]
0307593908	11	0	1	12	[1002, 2082, 9271, 293, 2366, 5524, 2429, 1593, 8577, 872, 3753]	[]	[5028]
0767802470	188	65	35	288	[4002, 1003, 17, 1026, 4025, 7025, 2034, 9039, 5051, 3033, 1055, 1062, 5060, 7037, 6041, 2049, 1077, 3050, 1101, 6069, 9095, 4131, 6089, 8086, 2113, 7094, 5159, 4182, 6118, 8115, 8122, 1207, 2154, 1219, 8134, 6143, 6146, 5235, 184, 5240, 1265, 6179, 5276, 5295, 1307, 3197, 1311, 9261, 258, 7204, 9291, 1361, 4376, 6246, 7226, 1396, 9325, 2297, 326, 3264, 9339, 6288, 1439, 9362, 1444, 5452, 8281, 4480, 8300, 9392, 4499, 2367, 395, 1506, 5518, 2377, 6338, 1518, 6345, 5536, 1526, 5542, 9450, 445, 9465, 8364, 5601, 2441, 8376, 8381, 485, 490, 8390, 2463, 1625, 1628, 6420, 4677, 2487, 3430, 5692, 7424, 4720, 1703, 6464, 4736, 6468, 8456, 1725, 6480, 5760, 9606, 9617, 6508, 7475, 9653, 7491, 3529, 3531, 5851, 661, 4870, 7516, 2632, 1867, 9710, 5887, 8550, 9723, 705, 6586, 5924, 8570, 7564, 5947, 1945, 751, 4983, 5982, 4994, 5987, 7591, 7592, 9796, 775, 1984, 3645, 7622, 807, 3663, 6673, 8648, 844, 3699, 6710, 7682, 2843, 3744, 906, 8714, 2860, 6760, 917, 2868, 2872, 3763, 3765, 7727, 2885, 6787, 2895, 8767, 3809, 984, 2939, 7788, 8813, 6865, 3864, 3887, 7839, 8891, 7888, 8910, 6957, 8925, 3989, 8996]	[3031, 2041, 4091, 6077, 4137, 5147, 4151, 8099, 4187, 4225, 3142, 1238, 199, 5313, 6227, 8224, 290, 1378, 330, 8263, 5444, 1445, 8286, 1460, 8292, 4489, 1479, 9402, 3320, 5516, 2388, 9459, 5593, 9486, 3390, 8385, 1619, 6460, 4734, 8451, 7440, 5738, 9624, 620, 2587, 7502, 3539, 8535, 7529, 1870, 2673, 5937, 736, 1938, 6617, 9784, 784, 791, 7669, 2857, 8764, 7767, 2945, 2996, 8986]	[5013, 2032, 8035, 9058, 95, 2140, 4192, 7124, 7142, 8195, 3213, 1344, 6261, 9328, 4464, 3298, 5513, 398, 4653, 7385, 5672, 6434, 2495, 3475, 4937, 1940, 861, 6734, 892, 899, 6751, 2866, 9965, 8846, 7962]
0782008380	3	5	48	56	[4469, 5715, 7649]	[9101, 8314, 8454, 7447, 8459]	[2, 2036, 9070, 8089, 2171, 6158, 5252, 198, 1299, 6229, 3230, 5386, 8277, 5533, 2389, 9463, 1617, 9514, 7404, 7442, 4772, 4795, 6534, 8544, 5888, 8549, 5907, 7543, 1902, 4967, 9779, 760, 1969, 7600, 3693, 2810, 3723, 8692, 2856, 930, 7736, 6808, 6823, 3830, 2957, 6894, 6909, 8966]
0767834739	6	10	41	57	[2157, 1376, 4443, 6423, 5675, 8944]	[9085, 1245, 4522, 1693, 8437, 8679, 7673, 7696, 2865, 8809]	[5003, 2019, 2023, 4055, 9050, 6064, 126, 131, 1173, 5177, 3116, 9157, 2203, 2210, 8187, 4339, 6272, 1421, 363, 2348, 6318, 1493, 5507, 5515, 3362, 4634, 1626, 5706, 1746, 5817, 7489, 9699, 7541, 2661, 704, 9791, 6876, 8868, 6954, 7917, 3976]
0780023110	1	2	6	9	[2253]	[2002, 811]	[4227, 7268, 8467, 4910, 9730, 2968]
0783211694	0	1	1	2	[]	[9114]	[4003]
0764005707	36	12	24	72	[8021, 4076, 9071, 5118, 120, 7132, 8164, 2207, 233, 1338, 8214, 1388, 9317, 2298, 9341, 7259, 4478, 7308, 8333, 4586, 4594, 6394, 1605, 482, 4675, 3425, 2507, 8478, 7525, 5894, 6576, 7540, 1929, 2752, 809, 3901]	[7052, 1182, 2170, 5414, 1548, 9499, 557, 5855, 7660, 3886, 7853, 3955]	[9003, 5066, 7089, 3135, 4233, 9212, 2223, 8206, 299, 5403, 423, 8351, 6387, 2503, 1690, 710, 1955, 6672, 9926, 8760, 989, 3894, 8869, 8974]
0767028627	5	5	2	12	[1009, 5101, 5291, 5525, 2545]	[5238, 586, 9748, 9837, 7761]	[3002, 9931]
0767726227	136	19	7	162	[3, 2011, 1019, 1029, 5029, 5031, 5036, 7023, 9032, 9048, 7044, 8060, 1100, 77, 8063, 6078, 4134, 4154, 2123, 4171, 9148, 5220, 3140, 1247, 5265, 6181, 3181, 6190, 4301, 5297, 9248, 5311, 4335, 7224, 6253, 2289, 1391, 316, 5424, 7273, 354, 6297, 2337, 3296, 4483, 3299, 4509, 387, 1501, 4533, 9426, 1545, 3356, 1553, 448, 5583, 1573, 456, 3371, 4618, 9491, 495, 3401, 6417, 4660, 506, 5653, 3413, 9528, 8408, 5682, 5687, 4698, 542, 6465, 570, 578, 5751, 8471, 1780, 4820, 6525, 9655, 4837, 640, 6531, 1806, 5838, 1816, 1839, 1847, 5870, 5875, 8546, 5914, 6615, 5958, 9773, 2709, 4984, 773, 7597, 3677, 7640, 7644, 9861, 8657, 2796, 6717, 2817, 6725, 3729, 2840, 7715, 8733, 2881, 2883, 9985, 9988, 975, 8774, 3821, 8793, 6840, 8797, 6854, 7840, 3899, 8871, 6923, 3920, 6935, 7934, 7965, 7980, 7981]	[5041, 1107, 1117, 7128, 4326, 295, 7252, 6346, 8336, 5615, 6410, 4655, 584, 5965, 7588, 8723, 7757, 8791, 3844]	[9130, 4173, 8157, 6178, 1516, 761, 6828]
0767026128	26	3	3	32	[7002, 8119, 5245, 1285, 228, 5301, 255, 5353, 1369, 4395, 333, 7270, 3302, 2351, 1491, 7305, 9437, 8342, 4567, 2569, 2610, 3616, 6722, 6802, 3816, 7966]	[39, 3404, 3721]	[9227, 1323, 7274]
0780628535	2	2	13	17	[8041, 1180]	[4172, 1788]	[5004, 7125, 1266, 1267, 4304, 9270, 2301, 8257, 1696, 1892, 7725, 2993, 6976]
0780627415	2	1	10	13	[7029, 8529]	[3198]	[6002, 6025, 9135, 8222, 4496, 462, 1584, 8407, 7804, 8870]
076400557X	39	2	1	42	[8002, 9007, 6027, 1092, 81, 83, 6086, 5143, 7110, 1188, 6142, 4286, 6187, 8180, 7175, 3217, 2292, 7272, 5492, 6332, 6390, 5611, 1618, 522, 3428, 9620, 610, 627, 1792, 9654, 672, 1894, 5921, 1927, 9772, 4989, 1994, 7826, 8893]	[7119, 8279]	[6244]
0767087372	78	14	15	107	[1004, 4018, 41, 4069, 5136, 117, 1157, 3100, 5183, 1185, 9149, 4204, 9160, 4212, 4261, 5263, 4307, 4328, 5343, 1358, 8238, 5397, 6274, 9356, 8275, 9358, 5466, 2347, 5481, 7295, 9399, 1489, 6334, 8331, 9484, 6397, 9498, 4642, 2476, 2482, 520, 5673, 4693, 1670, 4756, 8457, 3474, 6494, 2581, 5806, 6524, 637, 659, 1869, 7547, 1896, 7555, 726, 8590, 3615, 2707, 6637, 6642, 2757, 6666, 2814, 8698, 9940, 8722, 3759, 969, 8773, 2944, 7843, 8883, 3930, 3978, 7964]	[9035, 2076, 7138, 1246, 350, 8317, 8439, 2547, 2555, 9640, 5803, 6573, 6598, 9918]	[1071, 88, 8156, 8202, 4359, 2260, 5483, 5671, 9612, 1771, 6582, 1918, 1923, 2979, 7933]
0783223218	2	7	16	25	[6406, 1794]	[2094, 403, 7349, 6509, 744, 2827, 3771]	[2003, 4028, 1171, 9230, 6257, 2335, 6308, 721, 7607, 8640, 3779, 8746, 950, 9976, 8876, 7908]
076784744X	1	3	18	22	[7566]	[9161, 4463, 6444]	[4004, 2052, 2071, 6100, 4241, 1268, 5305, 312, 5651, 9529, 2501, 4778, 2570, 1765, 8618, 7779, 6872, 8879]
0767813871	2	1	4	7	[9004, 9895]	[5436]	[6487, 1895, 6665, 955]
0767736680	102	7	6	115	[4005, 56, 3055, 9072, 6060, 4102, 6091, 4156, 5168, 5175, 8116, 4199, 8138, 4237, 1254, 2189, 9208, 2199, 1271, 214, 218, 219, 6191, 5298, 240, 9249, 4337, 261, 9274, 1343, 6240, 2280, 1384, 5395, 5417, 9340, 5432, 347, 3286, 360, 1462, 7283, 4503, 3322, 401, 5550, 5578, 6382, 4612, 5618, 7389, 517, 4692, 3440, 6454, 5723, 8453, 9616, 2563, 607, 6504, 9630, 8491, 1778, 4826, 7492, 6528, 1801, 4861, 1836, 7523, 6572, 4914, 1887, 4920, 6592, 5931, 1934, 742, 1946, 9789, 1990, 2755, 9831, 818, 9869, 3701, 6723, 875, 2822, 6763, 3803, 6815, 6832, 6873, 6898, 7849, 8935, 6979, 8956, 8990, 7996]	[9105, 1237, 8236, 7249, 421, 6502, 9775]	[8015, 9075, 2088, 5173, 6377, 3485]
0767823990	1	0	2	3	[5005]	[]	[1681, 3456]
0780621832	1	1	3	5	[6197]	[4]	[6431, 4966, 8592]
0764004425	14	2	7	23	[3003, 3028, 296, 1662, 568, 4747, 4808, 1862, 1877, 4923, 1907, 2677, 1932, 8906]	[7066, 8410]	[8050, 7136, 2269, 9368, 510, 3866, 8918]
0783223358	3	3	46	52	[4458, 8666, 6745]	[6310, 3340, 6901]	[1005, 5025, 1061, 1099, 7071, 7081, 137, 5206, 165, 5215, 4223, 3182, 7178, 3226, 5369, 1365, 325, 1416, 4474, 429, 6385, 3378, 5650, 3411, 6474, 3524, 9691, 8530, 2651, 1881, 1882, 3572, 1885, 9729, 1915, 5968, 6652, 8626, 6705, 3750, 8747, 6800, 3849, 3896, 6913, 3943]
0780630866	1	0	2	3	[8827]	[]	[6003, 1255]
0739046500	6	0	2	8	[7003, 5056, 9117, 1511, 5850, 5970]	[]	[6105, 9181]
0767002652	253	28	39	320	[8003, 8016, 1034, 2024, 3021, 9027, 1035, 27, 2039, 5054, 6047, 60, 5086, 4087, 1090, 9073, 4096, 4100, 6065, 8069, 6076, 101, 8082, 9112, 2106, 2107, 118, 2112, 2114, 6108, 6109, 6110, 3108, 6115, 2139, 3118, 6123, 5194, 6126, 1210, 164, 4222, 5219, 1222, 6145, 1225, 7134, 1226, 2169, 8140, 3145, 8145, 8147, 9194, 8151, 2181, 7148, 5251, 3163, 4270, 6174, 9214, 2202, 4290, 4312, 3196, 9253, 1318, 8200, 9264, 263, 2251, 4361, 1351, 2262, 5370, 1370, 3241, 2281, 5387, 8240, 1381, 3252, 2294, 9323, 6266, 4431, 1422, 8268, 5435, 4445, 3275, 8270, 5442, 2324, 1437, 4475, 7281, 5473, 2345, 5474, 4486, 3303, 3304, 9389, 4497, 8306, 6321, 8311, 3319, 392, 6331, 9411, 1503, 2384, 5532, 6349, 2396, 5547, 5551, 9446, 8346, 8348, 1557, 442, 2416, 446, 4595, 2424, 4600, 7365, 4637, 4638, 487, 4641, 492, 1620, 9510, 6411, 5643, 9517, 6415, 3407, 9521, 1635, 5659, 3423, 8416, 9543, 7409, 1668, 4705, 8429, 6449, 5713, 1697, 4733, 5726, 6466, 8448, 567, 4749, 2534, 3467, 2542, 9605, 6491, 592, 5772, 2561, 603, 4797, 2571, 3497, 5801, 622, 2596, 5825, 9660, 1803, 1808, 2604, 650, 8519, 6544, 8521, 9684, 6549, 9697, 4890, 684, 2646, 6571, 9715, 8556, 9727, 1891, 3577, 3582, 1914, 2701, 795, 9841, 3673, 825, 3679, 9862, 2797, 852, 9883, 7671, 8688, 880, 2836, 9919, 6750, 9934, 7706, 7710, 9942, 3755, 7713, 7731, 8742, 6809, 981, 8782, 8787, 8788, 2961, 6852, 7813, 3868, 6883, 7828, 6893, 6895, 3898, 8865, 6912, 3911, 3912, 7874, 7893, 8907, 8912, 7907, 8923, 8929, 7932, 6995, 7954, 8991]	[8012, 9055, 2141, 5191, 6133, 6184, 4345, 8269, 3284, 3306, 2373, 8329, 6388, 493, 6412, 543, 6458, 2518, 8499, 652, 7505, 4858, 679, 7531, 7532, 2647, 9759, 7584]	[5047, 9047, 8042, 9082, 1113, 133, 8165, 5275, 6198, 3259, 327, 1426, 3310, 8304, 382, 2371, 7358, 8374, 9501, 5635, 3405, 5665, 3429, 9565, 8477, 4796, 3526, 3533, 662, 9714, 1974, 3650, 3698, 9897, 3780, 2923, 3863, 3942, 6952]
0307142469	35	4	1	40	[2004, 2027, 2045, 6070, 1200, 4239, 2194, 3173, 4319, 1320, 4329, 3222, 6236, 7240, 5499, 3327, 3334, 4545, 5537, 2411, 5595, 3418, 4727, 3517, 698, 5912, 4965, 8594, 782, 9906, 923, 9956, 8744, 6825, 3847]	[7, 6015, 2245, 988]	[5966]
0780656946	3	4	31	38	[5678, 5977, 936]	[2022, 2318, 720, 4963]	[9005, 2037, 4071, 64, 5090, 9104, 6097, 5165, 9150, 9185, 6159, 1272, 5322, 269, 5380, 9348, 4507, 7311, 1543, 434, 2454, 5641, 7394, 6559, 8564, 8708, 2934, 3831, 2950, 7832, 8941]
0773343032	0	1	10	11	[]	[4006]	[129, 6185, 1456, 9388, 1477, 1532, 1845, 8578, 9850, 9978]
0307514161	109	12	6	127	[9013, 7017, 5046, 35, 8033, 7046, 1083, 8059, 3063, 4104, 3066, 92, 9099, 8088, 1151, 9127, 5164, 5182, 159, 9167, 7131, 8148, 9200, 4258, 5260, 1262, 2214, 8184, 241, 3195, 6218, 7201, 9279, 272, 8219, 3224, 4366, 9292, 4373, 8237, 8242, 2290, 7253, 4455, 8298, 4508, 6329, 9407, 4546, 9436, 5544, 7331, 9449, 2405, 5561, 2408, 5570, 2417, 3366, 9468, 2422, 8362, 7370, 4644, 4678, 9536, 6430, 3448, 9611, 6497, 3490, 5786, 4802, 9667, 669, 2634, 690, 697, 1890, 6599, 1965, 2728, 3636, 6646, 6659, 8628, 9830, 7646, 8660, 2803, 8678, 3719, 7678, 8697, 912, 6792, 7742, 6799, 6827, 3878, 3884, 3890, 3919, 7897, 3973, 6989, 6990, 7951, 7973]	[2005, 48, 9100, 2243, 1408, 1441, 9505, 5654, 1646, 6650, 7685, 7717]	[1259, 4558, 9508, 7513, 8704, 7705]
0783222734	2	0	14	16	[1007, 8905]	[]	[5139, 7112, 3143, 2328, 7317, 1760, 8481, 1905, 3595, 3602, 5979, 9881, 8681, 9925]
0767019954	29	8	4	41	[6004, 2017, 2021, 3110, 1261, 3203, 1335, 1340, 6264, 4492, 9397, 2421, 1594, 5649, 512, 4688, 3481, 6530, 671, 9720, 3573, 8600, 7604, 3653, 6670, 9865, 2839, 9933, 8789]	[3016, 3206, 9313, 9346, 453, 7384, 6804, 7991]	[6245, 4561, 3600, 2828]
0767025075	3	3	2	8	[9006, 9024, 2385]	[6651, 8693, 8877]	[212, 1475]
0767839277	0	1	4	5	[]	[1346]	[2006, 2096, 1389, 6522]
0764005316	27	2	3	32	[7005, 4077, 4210, 2227, 6215, 3214, 4365, 6237, 2296, 2306, 9354, 5610, 4627, 2464, 521, 8447, 9602, 1783, 8507, 5941, 5978, 834, 3711, 6761, 6807, 3811, 7844]	[5721, 7827]	[9631, 3768, 3778]
0767809270	1	0	6	7	[11]	[]	[6, 310, 8253, 4602, 1884, 8632]
0780619609	0	2	6	8	[]	[1342, 4667]	[4008, 8123, 3131, 6241, 4406, 1614]
0767020308	86	21	18	125	[2007, 4014, 1016, 5026, 4033, 5048, 5077, 4084, 9080, 5107, 9097, 1175, 5179, 142, 1184, 9147, 3132, 194, 5256, 6167, 5264, 5266, 1282, 9233, 8183, 5327, 5335, 8215, 4360, 6235, 1360, 7227, 324, 5433, 2325, 348, 8284, 3290, 1465, 1472, 9393, 4584, 2446, 486, 5636, 9522, 9523, 1659, 3445, 6505, 1773, 2583, 3507, 4823, 2595, 3519, 8515, 4851, 8520, 3544, 682, 3584, 3588, 2683, 6608, 3635, 1985, 6661, 6676, 8672, 3716, 7676, 6748, 6778, 9975, 7753, 8775, 8776, 7772, 3851, 6871, 8884, 3926, 6940, 6994, 8971]	[2014, 5102, 4128, 9163, 3199, 7206, 380, 9396, 6365, 2490, 2504, 9644, 6587, 8563, 3651, 9930, 6767, 6857, 6915, 3916, 7884]	[3009, 6033, 111, 6119, 157, 7164, 3374, 8379, 8469, 2558, 1761, 7480, 1855, 3601, 9764, 3810, 7903, 3992]
0780618564	0	1	8	9	[]	[609]	[6005, 5190, 7185, 1630, 5718, 1919, 7641, 8715]
0780628551	1	9	33	43	[8862]	[1167, 9255, 5421, 3291, 7371, 4649, 1641, 859, 3974]	[8005, 9067, 97, 6107, 8102, 2152, 5233, 6202, 1355, 4389, 9310, 4414, 4482, 3307, 402, 1606, 8386, 4657, 4684, 7405, 6447, 9562, 9568, 3560, 4911, 9731, 4930, 2671, 1937, 7577, 6841, 6881, 3984]
0780623134	3	0	10	13	[1010, 1457, 553]	[]	[7101, 4240, 9394, 3324, 5579, 6436, 7450, 771, 7861, 7994]
0780020685	4	4	11	19	[5092, 9538, 9892, 6950]	[5009, 7476, 9904, 3934]	[4047, 2174, 4305, 4369, 308, 7251, 8305, 3379, 8581, 3707, 931]
0767833902	3	5	53	61	[357, 5477, 2970]	[6084, 4331, 7386, 9533, 7545]	[4009, 1032, 1063, 5105, 2118, 5174, 5181, 6148, 6168, 9211, 8174, 249, 1322, 302, 1382, 3267, 2332, 1458, 3301, 376, 2380, 415, 5541, 9441, 5568, 6428, 8414, 4702, 9554, 4717, 5733, 9590, 2538, 4886, 9709, 692, 4909, 7537, 2687, 8654, 6691, 6704, 9889, 883, 3736, 9986, 7782, 8815, 8844, 3888, 3951, 6971, 7978]
0767824555	1	1	2	4	[9008]	[4404]	[4072, 2686]
0764003828	44	11	6	61	[6006, 20, 1030, 8018, 6019, 5049, 5114, 2105, 3099, 8106, 1183, 1199, 3139, 4232, 5310, 6204, 9295, 4375, 5385, 2300, 2379, 1541, 8350, 6403, 4643, 1636, 7397, 3433, 4709, 1683, 8435, 4760, 9625, 2584, 7488, 5898, 7576, 5988, 798, 7666, 6795, 9996, 3819, 3867]	[4273, 4411, 1563, 5581, 459, 7569, 9797, 7598, 9969, 6983, 7969]	[2087, 6277, 9405, 7623, 7728, 8786]
0767836316	0	4	9	13	[]	[1011, 1609, 655, 1963]	[9111, 175, 4275, 1702, 3499, 5833, 8511, 1962, 2760]
0780620321	0	1	6	7	[]	[2608]	[4010, 6283, 7327, 4986, 6679, 7830]
0767851668	3	5	34	42	[8, 9176, 5362]	[7170, 4355, 3248, 6355, 7653]	[6020, 2044, 3052, 4149, 8097, 7114, 1196, 6176, 5344, 4356, 281, 8235, 8303, 4547, 518, 7416, 554, 5729, 1748, 613, 6516, 663, 717, 7614, 799, 855, 895, 2853, 2947, 2989, 3924, 7889, 8959, 7950]
0780605799	1	1	7	9	[5359]	[3068]	[8006, 3162, 4363, 5574, 8418, 7778, 8940]
076400235X	20	2	1	23	[9009, 1028, 4194, 8137, 5278, 9286, 7241, 370, 5590, 2434, 2479, 8412, 530, 648, 2612, 2640, 5909, 2679, 5943, 8728]	[1314, 9567]	[6090]
0767018877	2	1	2	5	[9440, 9785]	[4903]	[5011, 7238]
0780631153	4	12	47	63	[4160, 5357, 277, 2655]	[51, 9077, 5200, 1203, 7344, 4703, 3460, 7446, 3720, 2882, 940, 3859]	[3007, 5038, 5071, 5080, 7050, 1089, 105, 9155, 8159, 213, 1303, 6221, 265, 2263, 2304, 1435, 4467, 7290, 1515, 4544, 6353, 4566, 1583, 9483, 2462, 2468, 6421, 8426, 9584, 5797, 4821, 3525, 8543, 3569, 5908, 722, 3594, 8610, 9812, 2770, 7654, 6753, 8740, 958, 8806, 8882, 7924]
0307142485	49	3	2	54	[1012, 4037, 4056, 8052, 5121, 6117, 3130, 3154, 6169, 7169, 6199, 2226, 1305, 2231, 2287, 9326, 7302, 9434, 1610, 6416, 7391, 9527, 1647, 5719, 4768, 7462, 5818, 1820, 4884, 3564, 4935, 7578, 8601, 768, 6641, 2739, 7630, 7638, 8727, 8730, 6777, 6797, 6830, 2987, 3967, 7926, 7935, 3987, 8992]	[4265, 1380, 5638]	[3347, 3970]
0764000969	4	1	1	6	[7007, 5872, 4900, 8964]	[5281]	[8207]
0780630874	3	4	12	19	[9018, 1066, 8616]	[7579, 5991, 1982, 9857]	[4011, 1147, 9123, 1213, 4264, 3300, 5534, 3355, 9555, 6640, 8739, 9987]
0767821556	1	3	3	7	[4465]	[783, 8664, 7721]	[9, 1336, 757]
0767802519	1	3	9	13	[5012]	[248, 2524, 5904]	[8094, 2129, 2343, 2407, 5861, 2681, 765, 9792, 7659]
061529118X	4	0	1	5	[6007, 6018, 5034, 9810]	[]	[7871]
0767025784	3	0	3	6	[6048, 3292, 3731]	[]	[9010, 5332, 646]
0780621964	3	10	53	66	[3137, 5221, 5612]	[3104, 4202, 200, 4450, 7323, 3454, 4789, 2613, 3904, 7915]	[1013, 7027, 4073, 65, 2090, 1156, 9132, 2130, 5201, 9220, 6193, 250, 1326, 2255, 1364, 3247, 2299, 5425, 9343, 2316, 5453, 9377, 2364, 5523, 5549, 5555, 4571, 9453, 1578, 464, 4620, 474, 7396, 3444, 5710, 4728, 6486, 6499, 4818, 5810, 4829, 9665, 4855, 4859, 3543, 1849, 7587, 3709, 6741, 8749, 993, 3823, 8914]
0764002465	28	5	5	38	[7008, 6012, 87, 5161, 7098, 4260, 9268, 9334, 5493, 383, 5506, 7325, 7408, 4699, 5699, 1756, 9638, 4857, 4944, 7562, 754, 7618, 824, 6697, 2873, 3817, 3818, 3956]	[4040, 287, 9342, 7293, 5562]	[6040, 3124, 5241, 1312, 4650]
0767023765	44	10	5	59	[2010, 5039, 1049, 7045, 8067, 4174, 8109, 3117, 9195, 6164, 6170, 6177, 9252, 7188, 1334, 331, 2327, 4476, 1531, 2403, 7346, 2425, 3397, 4682, 2491, 5737, 629, 2600, 5843, 4877, 4950, 7585, 3627, 6649, 6714, 865, 6766, 2974, 2982, 8850, 7869, 8888, 6992, 8972]	[2064, 182, 8251, 394, 1519, 1749, 608, 4839, 2825, 2921]	[6211, 3257, 605, 2914, 8873]
0767824571	4	4	13	21	[3079, 1385, 2378, 1680]	[1669, 2575, 8624, 6664]	[8007, 3035, 4135, 1294, 4390, 1392, 3384, 1637, 4687, 8508, 6560, 6580, 6902]
0780630890	8	9	20	37	[4442, 5624, 2481, 3514, 2659, 767, 3883, 6919]	[4012, 3043, 1330, 5694, 5766, 4810, 9742, 3607, 770]	[5126, 195, 3160, 3172, 2218, 260, 3210, 4409, 455, 6391, 511, 1698, 4732, 4748, 6473, 4798, 3503, 9890, 921, 2964]
0767819640	0	2	0	2	[]	[3008, 7628]	[]
0767836359	3	1	8	12	[5488, 5644, 2962]	[9858]	[1014, 8153, 9238, 352, 3288, 1639, 1777, 8915]
0767817753	0	0	11	11	[]	[]	[6008, 5075, 8287, 9588, 9666, 660, 1904, 7697, 7730, 7811, 7912]
0767014812	29	6	1	36	[6068, 91, 150, 8126, 6137, 5224, 208, 8175, 1425, 5448, 5482, 4501, 1522, 4574, 507, 8440, 7454, 4813, 4876, 6588, 1917, 6729, 8691, 6793, 3845, 8818, 3870, 8874, 6920]	[4013, 7020, 2055, 1309, 5384, 2620]	[5115]
0767818024	0	0	4	4	[]	[]	[8008, 6147, 817, 8930]
0783219857	2	3	22	27	[1484, 7414]	[6563, 688, 786]	[5014, 5109, 7091, 1197, 201, 222, 1353, 7228, 1403, 1405, 7288, 5484, 6354, 7364, 3415, 534, 5759, 9776, 2800, 894, 3958, 7998]
0780620003	5	3	26	34	[5015, 8185, 478, 7473, 734]	[8132, 5268, 9851]	[7009, 7056, 4125, 8128, 4313, 3235, 4434, 3297, 4524, 4556, 6375, 471, 1598, 476, 5743, 1751, 1766, 7554, 8573, 9762, 4970, 1967, 1993, 9972, 7786, 7984]
0738920762	24	1	6	31	[2012, 6016, 7028, 8045, 4078, 6096, 4181, 188, 6160, 4340, 9287, 5427, 9366, 4539, 1607, 9560, 3443, 3542, 674, 8565, 1942, 3633, 7608, 3949]	[5124]	[7055, 6282, 8318, 8335, 6847, 8841]
0783222823	0	1	3	4	[]	[2622]	[6009, 1186, 4252]
0780626966	1	2	6	9	[2358]	[1162, 9757]	[8009, 5037, 9519, 5933, 2838, 6886]
0767812778	0	1	1	2	[]	[12]	[8562]
0764006770	53	20	19	92	[1017, 3032, 2053, 4088, 3060, 8064, 4150, 4157, 2122, 4170, 5176, 9179, 2175, 5283, 7167, 9251, 7187, 5317, 4333, 268, 274, 7229, 7239, 8262, 8293, 4498, 4506, 4613, 541, 4718, 4745, 3567, 3576, 4922, 3578, 3596, 8584, 3611, 6636, 2722, 6638, 6674, 6678, 8658, 3727, 887, 6746, 3788, 7808, 8821, 7819, 7859, 7942]	[9051, 3080, 6103, 1235, 2340, 9425, 5585, 9492, 5793, 5804, 5805, 9737, 9817, 8636, 3665, 830, 8670, 2832, 6813, 8886]	[2057, 5128, 8080, 3105, 5292, 1362, 9316, 328, 1453, 2362, 9408, 5634, 8422, 1682, 1857, 1868, 3587, 2864, 3813]
0740328271	22	3	1	26	[4015, 4045, 4139, 1149, 2146, 1241, 5255, 4303, 9315, 9318, 3325, 4536, 1525, 4659, 5661, 7574, 3644, 9843, 821, 9863, 3740, 6790]	[3312, 4782, 980]	[591]
0780621654	1	1	4	6	[6924]	[4016]	[9142, 3354, 3521, 3619]
0767849493	3	6	46	55	[7670, 3841, 6890]	[9031, 9136, 267, 5621, 631, 3532]	[2013, 14, 9034, 1047, 9044, 58, 1204, 5205, 4211, 9173, 1244, 5244, 210, 5293, 5345, 9280, 2271, 1368, 6248, 2355, 5510, 5521, 3346, 4590, 468, 8382, 1740, 7468, 2614, 3537, 6547, 5936, 8586, 9774, 1952, 5972, 5996, 8619, 7639, 6733, 9967, 7762, 2960, 7803, 6972, 7988]
0783117388	0	1	15	16	[]	[7422]	[1018, 1356, 368, 2470, 5771, 9704, 1865, 7558, 2726, 2819, 6849, 3853, 3897, 7863, 3948]
0780656172	3	4	27	34	[8010, 3654, 6997]	[1023, 9092, 4645, 590]	[5043, 9110, 7117, 8144, 8178, 1293, 231, 1540, 2419, 7345, 489, 9545, 1692, 555, 1796, 8547, 9745, 3618, 2725, 2730, 814, 7632, 838, 8659, 903, 3766, 7737]
0780616561	0	2	14	16	[]	[207, 4953]	[5017, 6057, 1095, 1315, 3251, 3268, 2440, 2466, 3530, 2618, 9740, 4975, 7977, 7985]
076785117X	2	1	18	21	[4017, 5250]	[8572]	[5062, 4188, 2182, 5314, 6226, 7312, 2412, 7347, 678, 5893, 2665, 2674, 2695, 9874, 965, 2933, 8936, 3991]
0780630904	1	3	13	17	[7538]	[5272, 7214, 3261]	[9014, 9015, 9078, 289, 4449, 8274, 3399, 1661, 5815, 9658, 810, 2998, 7923]
0764005685	47	21	14	82	[3011, 3071, 6104, 7113, 3120, 5199, 4226, 192, 3158, 7186, 9256, 8221, 5364, 4388, 7244, 4424, 7257, 6302, 9404, 2383, 6396, 546, 1688, 577, 7456, 9634, 3528, 3538, 6607, 8596, 4996, 8630, 9835, 2821, 3751, 9974, 964, 992, 2937, 6842, 7807, 8842, 6927, 7872, 6938, 3938, 7943]	[2020, 1052, 1076, 1079, 173, 2190, 206, 8210, 5381, 5391, 3313, 4518, 8321, 6372, 1572, 5757, 2556, 9725, 7601, 3848, 6882]	[6039, 3155, 205, 2338, 5567, 1556, 7419, 7429, 573, 9607, 6507, 3502, 8523, 7831]
076701409X	2	4	0	6	[7011, 9066]	[4061, 6122, 1233, 9495]	[]
0780626699	0	1	5	6	[]	[3087]	[6011, 8194, 4417, 2438, 8951]
0767800958	13	1	1	15	[8011, 6058, 85, 5155, 2125, 3159, 4292, 4572, 2607, 5852, 1936, 2772, 7801]	[9734]	[2965]
0738920525	29	4	3	36	[1020, 5045, 3054, 9090, 6085, 6099, 162, 3184, 7191, 1397, 4416, 5451, 4468, 3317, 4646, 8401, 1776, 5837, 673, 3568, 738, 9782, 7596, 2731, 8646, 954, 2932, 8814, 3895]	[3174, 8356, 2926, 3908]	[3457, 1813, 8634]
0780630858	8	7	33	48	[2042, 5130, 5315, 4358, 3255, 4430, 7418, 9685]	[5018, 2100, 1227, 2354, 2602, 3562, 857]	[4026, 69, 4103, 4107, 4126, 6087, 127, 2143, 5229, 7216, 9297, 5449, 349, 4472, 431, 9451, 7353, 6381, 5630, 7460, 4809, 9643, 8517, 657, 4894, 1935, 7581, 8599, 7606, 2812, 7689, 3961, 8958]
0780618556	1	1	19	21	[3012]	[7627]	[9087, 149, 2229, 2270, 8245, 5464, 374, 2370, 4550, 6350, 4582, 4631, 6409, 544, 6476, 6490, 5964, 3639, 2985]
0310274281	98	5	3	106	[7012, 8017, 9026, 2054, 4075, 4106, 2080, 5110, 1120, 8074, 6079, 3077, 98, 5127, 8092, 123, 4161, 7100, 9177, 2166, 9216, 5320, 8201, 1337, 2265, 2268, 1427, 1429, 339, 7266, 8278, 2330, 7280, 1464, 8296, 6324, 4521, 3323, 4541, 6344, 3353, 8345, 5565, 6371, 4589, 4592, 9475, 467, 8380, 1624, 8395, 1640, 1656, 3442, 9564, 1695, 1707, 3463, 7448, 6485, 5758, 1736, 6501, 7481, 2586, 7483, 3510, 6526, 9664, 1832, 4887, 9702, 5940, 6614, 4971, 5969, 9787, 2743, 9845, 3690, 8663, 9871, 8668, 9921, 6758, 9960, 8745, 9973, 3806, 7760, 7766, 2931, 3833, 8819, 6903, 8894, 3971, 8975]	[8105, 9140, 8111, 143, 9169]	[4347, 9733, 3869]
0767802624	6	2	4	12	[15, 9217, 4338, 5598, 5742, 920]	[1418, 4791]	[4030, 5727, 8551, 3998]
0767827929	3	2	6	11	[4019, 7116, 1720]	[8294, 5783]	[8120, 3471, 1858, 7560, 8598, 8898]
0767010485	30	7	5	42	[5019, 1074, 75, 3107, 4175, 1177, 3144, 1300, 7221, 6265, 3266, 1470, 8315, 2391, 6400, 6419, 6438, 6451, 3466, 6527, 9700, 2639, 5938, 5956, 9832, 6752, 6785, 8771, 8834, 6905]	[3048, 7084, 9152, 5262, 7343, 5871, 9777]	[5257, 1411, 6317, 3550, 9903]
0764000829	9	6	11	26	[4249, 7248, 6326, 4564, 748, 2861, 3790, 3865, 6877]	[5406, 5454, 5657, 9558, 4830, 7662]	[2015, 5134, 1483, 1752, 700, 837, 6698, 3706, 2917, 2981, 3965]
0782008348	2	1	10	13	[2236, 1663]	[836]	[9016, 7024, 3220, 5360, 4743, 2638, 4893, 4947, 843, 2805]
0764001035	54	16	11	81	[1022, 26, 2103, 5153, 2133, 9141, 7121, 4243, 6182, 1277, 5288, 2221, 6208, 2239, 2308, 4435, 2323, 7289, 8316, 5564, 463, 473, 475, 6413, 503, 524, 1673, 8449, 4752, 7463, 9622, 1805, 1826, 6554, 6562, 8542, 9712, 6575, 695, 5913, 718, 1924, 4957, 5963, 1973, 1992, 2813, 2816, 8682, 7680, 8778, 6879, 3875, 8983]	[6032, 4082, 9102, 1136, 1166, 7147, 9207, 1430, 8352, 6370, 9480, 519, 6450, 7572, 2909, 6810]	[5073, 6092, 1243, 9221, 9262, 1488, 9415, 5992, 788, 953, 8768]
0780023080	2	1	4	7	[2184, 893]	[3191]	[4020, 1025, 273, 2352]
0767817478	5	9	50	64	[5020, 3204, 5423, 9676, 3599]	[4085, 4253, 393, 8361, 9496, 8389, 1925, 833, 963]	[5035, 4079, 6071, 9093, 4124, 3083, 128, 5167, 4186, 1202, 4309, 5306, 7207, 4372, 291, 1372, 6251, 1379, 2286, 1410, 5418, 2309, 4437, 341, 9353, 5497, 8337, 5556, 2431, 8368, 4696, 549, 5778, 7477, 2588, 8524, 1850, 3591, 6600, 8579, 2715, 769, 785, 7661, 2842, 3741, 2862, 3814, 6843, 8998]
0767819403	1	1	1	3	[3376]	[651]	[9017]
076780161X	73	19	9	101	[2016, 6023, 4041, 1116, 103, 9109, 1206, 7140, 244, 1331, 4381, 4393, 301, 5398, 5400, 7286, 2360, 6330, 6347, 4549, 3357, 436, 1565, 8370, 4615, 7367, 6399, 7374, 7403, 5697, 9563, 547, 6463, 9578, 9597, 4774, 5779, 5811, 628, 1799, 1837, 5859, 6551, 9689, 2628, 5889, 2653, 696, 5917, 1899, 9763, 6621, 7583, 3623, 9798, 797, 6684, 9854, 8677, 9958, 939, 2894, 2901, 961, 3801, 3802, 6839, 8805, 3881, 6931, 7901, 7928, 8980]	[4167, 5187, 1274, 5289, 1306, 5328, 1536, 9455, 1691, 9589, 9614, 2573, 4844, 5879, 4919, 5939, 7655, 7693, 7894]	[5081, 86, 8090, 1178, 2418, 7381, 6764, 3785, 2911]
0767821785	1	0	3	4	[8255]	[]	[6013, 2574, 5916]
0780625218	1	1	3	5	[4621]	[1767]	[8013, 2648, 1898]
0780021096	0	0	5	5	[]	[]	[4021, 8228, 7452, 1861, 2774]
0764005537	18	6	3	27	[4022, 4383, 298, 9321, 4587, 2442, 4690, 8445, 3470, 2616, 4872, 4933, 6619, 907, 7707, 7817, 3985, 8969]	[9294, 4625, 4648, 3586, 6675, 2992]	[9303, 4833, 3682]
0767812158	0	0	1	1	[]	[]	[7014]
0767005880	10	1	1	12	[8014, 7159, 5340, 1383, 4422, 418, 1562, 1653, 9544, 3954]	[7918]	[6213]
0767823796	0	2	8	10	[]	[9632, 3738]	[3015, 7060, 5438, 4581, 4790, 5878, 9703, 7722]
0780619552	1	3	10	14	[2450]	[2201, 2288, 8961]	[18, 8023, 3073, 2246, 4494, 1486, 2585, 916, 6784, 6817]
0783225261	0	1	4	5	[]	[781]	[4023, 5104, 9422, 5717]
0767807588	0	0	7	7	[]	[]	[5023, 8087, 8196, 7202, 5426, 2924, 8934]
0767800761	45	6	5	56	[2018, 4053, 4054, 9049, 6044, 9076, 5140, 1223, 8143, 1253, 4276, 1280, 8189, 6230, 7220, 2284, 1399, 4471, 6305, 3305, 1502, 4535, 4548, 2392, 6360, 7333, 4596, 461, 5633, 4670, 7406, 6488, 2597, 7508, 664, 685, 4938, 6596, 4962, 7573, 827, 9966, 2904, 2988, 7902]	[7232, 8264, 369, 2400, 1613, 3807]	[6140, 220, 5402, 9344, 3714]
0767003357	64	10	19	93	[4068, 1080, 68, 4097, 3101, 4184, 4195, 4215, 2168, 4256, 8167, 5271, 3183, 251, 2241, 6224, 7203, 3228, 2273, 3236, 7223, 3253, 8285, 6306, 6312, 1494, 1510, 5559, 3358, 4580, 1579, 7393, 7407, 8419, 3435, 3453, 4737, 3482, 4784, 9626, 1770, 3513, 9657, 3536, 9681, 9688, 4889, 2663, 6593, 2678, 9760, 1951, 1971, 8620, 8635, 909, 9998, 6811, 990, 6853, 2980, 6939, 8931, 3986]	[9083, 9113, 1229, 6380, 8444, 7472, 8501, 2990, 3874, 3983]	[19, 1031, 9030, 6043, 3056, 3057, 5158, 8225, 9381, 9452, 1674, 5740, 7458, 5770, 1810, 7701, 3781, 7814, 8858]
0783103107	1	3	6	10	[5829]	[2346, 9503, 6521]	[9020, 29, 4510, 8736, 6859, 6955]
0767821955	1	2	9	12	[61]	[4871, 1852]	[1027, 7057, 7146, 1446, 9493, 2486, 531, 4915, 2849]
0767802497	20	13	24	57	[2025, 3023, 7035, 4058, 1103, 5195, 2164, 8179, 4316, 5558, 9476, 9485, 6482, 8486, 3608, 3676, 9870, 8719, 2871, 3946]	[4158, 4165, 9327, 6356, 5680, 4704, 563, 2541, 1731, 1872, 5953, 5983, 842]	[7016, 5027, 4065, 6074, 152, 5242, 9307, 356, 9390, 5494, 5498, 4554, 8347, 5626, 4712, 8464, 5816, 1835, 8603, 9823, 9901, 6765, 8754, 2907]
0736915842	4	2	0	6	[9021, 9749, 6629, 6921]	[8341, 3941]	[]
0780625528	1	1	3	5	[9814]	[1341]	[6017, 9178, 1876]
0767810864	1	1	3	5	[9022]	[8170]	[8231, 430, 3630]
0764006797	10	2	2	14	[3018, 7085, 6121, 6165, 8177, 1644, 579, 5762, 2938, 3900]	[3436, 8759]	[6114, 1325]
076400638X	11	1	1	13	[7018, 1038, 9143, 9443, 4676, 668, 3566, 1956, 9808, 2829, 2976]	[104]	[3762]
0767827007	1	3	6	10	[8642]	[353, 5465, 8800]	[5030, 8022, 9406, 3462, 8452, 2676]
0307141985	4	1	0	5	[23, 9116, 2546, 7512]	[7263]	[]
0780021088	1	1	6	8	[7099]	[4500]	[8019, 8141, 6153, 3260, 5459, 571]
0780622642	7	5	24	36	[4029, 5373, 9398, 2426, 3613, 820, 8705]	[3186, 9319, 5932, 829, 9968]	[7036, 1143, 3098, 9231, 230, 9333, 4504, 5522, 7318, 5586, 1577, 6429, 4680, 3452, 4776, 5767, 599, 9637, 8493, 7519, 7626, 9838, 2769, 8808]
0767802802	0	2	5	7	[]	[2399, 2784]	[1033, 1108, 465, 6479, 7615]
0780627784	1	3	5	9	[2666]	[5151, 4840, 2880]	[9025, 2120, 2213, 4343, 6401]
0005119367	85	5	2	92	[24, 2033, 4044, 4049, 5052, 3034, 7032, 9045, 8054, 4108, 4130, 2095, 2126, 2131, 4183, 153, 5214, 5217, 4236, 6166, 5267, 8166, 4274, 7174, 238, 8193, 5334, 4351, 9282, 3229, 4378, 3240, 8244, 1393, 1402, 6290, 3282, 3283, 8280, 2336, 8308, 4540, 9427, 1551, 5606, 2444, 3387, 2449, 5628, 8403, 1718, 4757, 1747, 4786, 1758, 9645, 2605, 1841, 8538, 6569, 8552, 6605, 9770, 6631, 2720, 6655, 2775, 2793, 2835, 6743, 7703, 945, 7759, 2925, 996, 8863, 7856, 8875, 7886, 6949, 6980, 7936, 3990, 7949, 8989]	[6239, 6279, 494, 5730, 4793]	[6555, 7789]
0783219695	3	2	9	14	[8020, 2147, 9236]	[6273, 6926]	[76, 1350, 1558, 1616, 5749, 1737, 4874, 1960, 1972]
0782008062	0	1	3	4	[]	[4421]	[5032, 4931, 8667]
0764005553	29	5	2	36	[4031, 40, 2061, 6139, 7150, 203, 4314, 266, 3237, 9312, 4440, 5646, 5731, 5788, 7497, 5873, 2636, 5876, 3557, 753, 4995, 2718, 8639, 9893, 8696, 3799, 8796, 6986, 7986]	[8055, 4098, 8211, 933, 8953]	[1542, 2557]
0767844335	0	0	1	1	[]	[]	[5033]
0767817672	2	2	1	5	[5485, 2846]	[4032, 9372]	[8217]
0767802659	5	7	31	43	[4050, 8160, 4514, 5584, 8554]	[3022, 1359, 5458, 1645, 6660, 9938, 971]	[1037, 2026, 2058, 5129, 3092, 8093, 2134, 7109, 5197, 1208, 4285, 315, 351, 6303, 371, 1523, 7340, 2458, 9583, 3461, 7445, 3495, 3546, 4895, 739, 2717, 7625, 2795, 7658, 7691, 6998]
0783222955	0	2	9	11	[]	[1036, 8339]	[4127, 1148, 4353, 3369, 9600, 5849, 1880, 706, 7549]
0782005926	0	0	1	1	[]	[]	[9028]
0767817680	3	2	11	16	[8149, 5445, 823]	[4048, 6851]	[7021, 5106, 6209, 4341, 9570, 2553, 4940, 9771, 752, 6633, 6801]
0767821408	0	0	8	8	[]	[]	[6022, 9037, 7118, 8302, 5577, 9471, 9876, 2806]
0780651359	3	2	5	10	[9029, 539, 7906]	[1417, 6768]	[4083, 4089, 4180, 3127, 8249]
0783219458	0	1	6	7	[]	[5705]	[7022, 7153, 1284, 666, 6648, 9848]
0767802594	1	1	6	8	[1589]	[1252]	[4035, 8349, 6443, 9738, 3877, 7898]
0738921351	5	1	1	7	[8186, 6471, 9847, 8781, 3922]	[3024]	[5637]
0767817443	2	9	37	48	[5132, 910]	[1072, 6247, 4448, 9432, 1546, 5787, 4812, 1916, 5990]	[28, 1046, 5053, 2040, 6055, 4095, 8068, 144, 2215, 5303, 3201, 7212, 9300, 4379, 2307, 3287, 405, 2381, 3349, 3368, 6398, 9500, 565, 1730, 1800, 2654, 4998, 3640, 9818, 9820, 796, 8633, 9834, 2762, 6814, 3918, 7958]
0767803329	0	2	3	5	[]	[1039, 2173]	[1239, 9259, 6550]
0767802454	24	12	25	61	[4036, 3037, 9052, 1098, 3070, 5150, 5156, 8125, 5237, 4368, 4403, 7313, 4573, 6418, 7444, 4783, 2705, 1954, 8612, 6735, 2972, 6880, 6944, 7914]	[7163, 5548, 1603, 7387, 9551, 2519, 6506, 7594, 8637, 7816, 7883, 8978]	[3040, 7149, 9250, 5342, 5367, 4495, 9409, 5588, 4607, 6426, 9547, 7436, 2527, 3515, 2617, 691, 2713, 6656, 6706, 9928, 905, 3745, 6796, 8831, 6945]
0780022343	0	0	1	1	[]	[]	[2028]
078060718X	0	2	15	17	[]	[9059, 7590]	[1040, 1139, 1193, 1249, 9241, 8319, 3416, 3431, 5885, 5901, 3743, 3772, 3871, 7892, 6959]
0767821548	1	1	6	8	[6613]	[3190]	[4038, 6156, 9308, 5613, 6405, 8505]
0767810880	2	3	5	10	[3026, 4891]	[7088, 4257, 3223]	[3067, 9131, 479, 683, 3756]
0307142493	51	5	2	58	[1043, 1048, 2059, 2060, 1109, 5149, 6136, 7127, 5316, 6214, 271, 4380, 8233, 8234, 3243, 5390, 2315, 4517, 1512, 4552, 4563, 6361, 9467, 4599, 1575, 4606, 6384, 4617, 8377, 1657, 3426, 5688, 5696, 3504, 6514, 4846, 3541, 9708, 6567, 687, 4981, 8638, 7629, 9898, 2858, 956, 3797, 8845, 6948, 6956, 8913]	[1041, 5079, 9369, 1499, 2995]	[8283, 713]
0307142477	2	0	4	6	[8025, 5091]	[]	[4052, 8372, 6433, 1802]
0767814932	0	0	4	4	[]	[]	[2030, 5747, 4885, 5989]
0307554066	11	1	6	18	[2067, 424, 458, 2430, 3609, 1995, 8675, 911, 7718, 6845, 3885]	[5088]	[1042, 5341, 2591, 3783, 3796, 3909]
0767000099	3	1	1	5	[3027, 994, 8902]	[7686]	[639]
078322530X	0	2	6	8	[]	[4863, 4990]	[6026, 2078, 3276, 4948, 8897, 8987]
0780619250	1	3	24	28	[677]	[180, 8150, 1423]	[32, 6028, 2216, 7269, 7301, 8323, 7335, 4576, 3381, 1676, 2559, 4822, 1798, 5824, 8525, 5905, 7561, 1961, 2785, 9977, 9992, 7875, 6969, 7968]
0767805712	2	4	4	10	[8027, 7945]	[3112, 1757, 4815, 2748]	[2081, 5308, 1530, 5707]
0767816234	1	5	11	17	[3659]	[2224, 6298, 5732, 5900, 8955]	[4042, 1082, 7068, 2111, 4868, 2635, 6643, 2742, 9943, 3760, 2889]
0782011098	0	0	3	3	[]	[]	[4043, 9799, 8904]
076780094X	14	12	24	50	[33, 8037, 283, 3245, 2311, 3364, 9540, 614, 1815, 6612, 3704, 6774, 8799, 6870]	[9043, 8043, 7097, 7231, 1651, 8506, 5827, 3776, 9990, 8866, 6918, 8973]	[5117, 4141, 113, 8113, 9158, 196, 9229, 1291, 6216, 264, 9289, 6242, 7234, 6263, 6270, 4441, 4529, 4598, 5679, 7410, 8473, 3496, 5812, 3656]
0767818075	0	1	3	4	[]	[6925]	[5044, 8028, 1420]
0767836286	1	2	17	20	[3832]	[2443, 9855]	[3029, 5097, 7126, 4394, 4436, 1521, 4652, 5647, 5695, 9627, 9750, 727, 856, 8683, 9915, 6757, 7855]
0783216084	2	4	11	17	[9311, 9948]	[3468, 804, 9913, 8857]	[1045, 1081, 7093, 4419, 8301, 5792, 2811, 978, 8825, 3889, 3962]
078322544X	1	4	11	16	[6749]	[34, 4074, 1132, 6342]	[7152, 3169, 3329, 7378, 723, 731, 2884, 951, 2920, 8968, 7956]
0767804252	1	1	9	11	[3555]	[991]	[3030, 2165, 7255, 8290, 4487, 5529, 8498, 3548, 8784]
0767814908	1	2	8	11	[3194]	[9859, 3705]	[6029, 7076, 1152, 1214, 4764, 7684, 2854, 8798]
0767801601	15	4	2	21	[36, 2075, 3081, 6175, 6327, 3338, 6440, 1711, 1991, 9819, 2778, 3734, 8706, 2876, 6962]	[8162, 3330, 7459, 9815]	[477, 9739]
0767816617	0	2	3	5	[]	[8133, 9668]	[6030, 5434, 3988]
0780620135	0	1	2	3	[]	[1591]	[2035, 5668]
0310285569	5	0	0	5	[9038, 262, 1555, 606, 8651]	[]	[]
0767818040	0	1	10	11	[]	[5882]	[1050, 6052, 70, 6625, 758, 779, 2741, 2890, 7833, 3928]
0783219571	2	1	1	4	[5050, 1126]	[2643]	[9156]
0783224079	2	0	20	22	[9556, 5834]	[]	[1051, 1130, 7082, 8085, 108, 7115, 3280, 5500, 2427, 1582, 472, 562, 2564, 658, 4921, 5952, 8593, 2855, 9944, 7756]
0780631234	3	0	10	13	[9539, 2505, 9917]	[]	[38, 7166, 8252, 7282, 2356, 6367, 2603, 9671, 6878, 7921]
0783219806	1	1	4	6	[6908]	[1172]	[8032, 3207, 6708, 3834]
0780630882	2	3	22	27	[2159, 7745]	[3072, 9193, 7267]	[1053, 9091, 1134, 4146, 3094, 4166, 4323, 5361, 1386, 1634, 6459, 6470, 9603, 4788, 4794, 7478, 3695, 6718, 904, 3858, 7850, 8965]
0780623274	0	0	6	6	[]	[]	[2038, 5504, 5725, 9582, 6556, 2700]
0741100967	5	0	2	7	[1054, 7041, 7603, 9900, 8801]	[]	[145, 2554]
0780619765	2	0	0	2	[9042, 5986]	[]	[]
0780618548	1	0	5	6	[9504]	[]	[6034, 1104, 122, 2453, 484]
0764004719	6	0	1	7	[9144, 3141, 1733, 9706, 4961, 5975]	[]	[5055]
0783221487	6	10	57	73	[9094, 6081, 6120, 5663, 1759, 7919]	[4062, 3051, 8056, 4250, 9482, 5614, 598, 8684, 7738, 8948]	[8034, 5057, 6061, 102, 5138, 110, 5148, 1216, 8154, 9202, 1263, 209, 6200, 270, 1374, 4398, 2293, 3273, 8324, 9429, 2404, 433, 7334, 2413, 7348, 6389, 4632, 6404, 5648, 5674, 5681, 5708, 7433, 564, 2526, 8462, 7451, 4804, 5796, 8509, 7503, 4924, 1920, 4979, 6623, 780, 2751, 2791, 2815, 9955, 9961, 6819, 3812, 7784, 7805, 6891, 7837]
0767024427	1	1	4	6	[8363]	[4952]	[6035, 8077, 6645, 7798]
0767817656	0	2	12	14	[]	[3119, 8387]	[43, 1064, 2119, 5366, 1627, 8433, 6484, 4906, 9786, 3710, 918, 2994]
0767025105	4	3	2	9	[4057, 9431, 8769, 7802]	[9330, 5582, 3500]	[7173, 3465]
0767830520	1	0	19	20	[7242]	[]	[1060, 82, 115, 6112, 4197, 6180, 2238, 6293, 7276, 2369, 4656, 5658, 9586, 4766, 7510, 8645, 3737, 6858, 7940]
0738921475	12	0	0	12	[5058, 53, 1073, 74, 5108, 1124, 9115, 135, 4836, 7665, 869, 8917]	[]	[]
078321958X	2	9	7	18	[1762, 3879]	[2043, 211, 4300, 4382, 6250, 444, 8495, 1833, 7563]	[6066, 9175, 3178, 3185, 5948, 4972, 8772]
0780627806	1	8	9	18	[7457]	[3038, 109, 4205, 3311, 1581, 7441, 3700, 7975]	[5059, 8044, 6212, 5828, 8613, 845, 7667, 3854, 8835]
0782006795	1	2	4	7	[6038]	[8680, 7724]	[1497, 9464, 7751, 7890]
0767827724	1	0	1	2	[45]	[]	[7664]
0767817737	0	0	5	5	[]	[]	[3039, 1258, 7342, 5836, 2809]
0767018702	6	0	0	6	[4060, 4555, 2395, 6472, 9633, 750]	[]	[]
078062372X	0	0	4	4	[]	[]	[46, 7306, 1785, 2946]
0764002589	3	3	0	6	[3343, 5920, 8950]	[5061, 3171, 1700]	[]
0767805739	2	0	8	10	[8404, 6803]	[]	[2046, 1165, 313, 2693, 2771, 6738, 7712, 6805]
0783224443	0	0	2	2	[]	[]	[7038, 6910]
0780020723	1	1	4	6	[47]	[8843]	[2193, 1571, 8503, 6690]
0767026225	7	3	1	11	[1065, 1270, 7254, 3473, 4958, 803, 8729]	[5137, 1701, 2799]	[2936]
0780631684	2	4	23	29	[8608, 8701]	[5208, 2228, 1498, 2694]	[5063, 1085, 4327, 7225, 4429, 7279, 5475, 8299, 7291, 9416, 3406, 2551, 4892, 858, 8673, 6755, 941, 3774, 943, 946, 2900, 3940, 8988]
0767819586	4	6	18	28	[5094, 1298, 314, 3508]	[2235, 5620, 8415, 558, 9613, 7829]	[4063, 275, 6295, 5461, 1490, 7316, 1537, 9494, 8455, 3479, 6510, 6539, 3621, 9795, 789, 2808, 9951, 7997]
076781083X	0	1	4	5	[]	[7533]	[4064, 8496, 4882, 6603]
0767823931	0	0	2	2	[]	[]	[8040, 615]
0767816757	1	0	3	4	[7135]	[]	[2048, 7431, 2758]
0783114893	0	1	8	9	[]	[4946]	[1067, 5331, 1612, 1793, 9821, 2763, 9916, 6988]
0767800311	7	1	5	13	[5212, 3250, 560, 8502, 2599, 1944, 7777]	[6254]	[49, 9172, 4374, 7455, 3575]
0764005022	16	13	6	35	[2222, 5346, 9349, 9473, 8378, 2483, 9534, 4700, 581, 5821, 8548, 1875, 2656, 747, 8621, 3995]	[6042, 4162, 6155, 8176, 4324, 8258, 5655, 566, 3493, 4849, 9927, 6855, 3855]	[4155, 8130, 2675, 9753, 5949, 7771]
0780020820	0	1	3	4	[]	[8867]	[5065, 7040, 5519]
0780622537	1	3	10	14	[3775]	[174, 2334, 8310]	[1068, 3059, 3152, 8197, 5503, 5652, 4719, 9735, 3747, 3842]
0767832302	0	3	14	17	[]	[3064, 514, 9722]	[50, 6049, 2208, 2219, 243, 4452, 1586, 4685, 6448, 9663, 4902, 7571, 7619, 3829]
0767015533	26	5	1	32	[9053, 7048, 4115, 3088, 4169, 2142, 172, 5234, 5261, 1269, 7192, 6223, 1377, 319, 4528, 2394, 1580, 7423, 1728, 6536, 4904, 1931, 5985, 2802, 6711, 3963]	[1119, 6259, 8288, 7299, 1769]	[4954]
0767825411	2	2	15	19	[4853, 9695]	[1174, 9170]	[1069, 1137, 5142, 9363, 4479, 3535, 7535, 1912, 6601, 3598, 9828, 6770, 7775, 7809, 7992]
0767806239	0	3	8	11	[]	[4067, 6532, 3703]	[5225, 4391, 4673, 9656, 9751, 3649, 932, 7815]
0783225199	2	2	10	14	[9054, 9205]	[7466, 8881]	[1324, 6231, 515, 8485, 9649, 5874, 8539, 4932, 5971, 9866]
0767016351	11	3	0	14	[3044, 1088, 8061, 3090, 2401, 6364, 7339, 7425, 6481, 8591, 6824]	[2350, 8360, 7752]	[]
0769720226	0	0	1	1	[]	[]	[2051]
0767853636	4	9	20	33	[5249, 4289, 5309, 5393]	[80, 8101, 2149, 359, 5469, 1476, 9489, 5777, 6974]	[5069, 9098, 4179, 4352, 305, 9382, 2365, 443, 1568, 9490, 3388, 1677, 5698, 675, 8735, 7749, 8820, 7824, 3937, 8995]
0740318934	19	1	7	27	[52, 3093, 132, 4228, 8188, 8198, 7294, 449, 3370, 505, 5689, 6469, 569, 5814, 7499, 2845, 8852, 8889, 6936]	[3422]	[9267, 9754, 777, 2750, 6685, 7694, 7822]
0767817486	0	0	8	8	[]	[]	[4070, 1513, 5545, 5589, 1903, 6662, 8763, 8872]
0780607465	0	0	2	2	[]	[]	[7043, 6445]
0764009265	9	5	5	19	[1075, 2074, 6335, 7400, 9707, 5922, 863, 886, 3872]	[1218, 3336, 5735, 8611, 860]	[9056, 4142, 5356, 4523, 3668]
0780022300	2	3	12	17	[7812, 7867]	[6046, 9435, 2773]	[4178, 3271, 1671, 4710, 9577, 4755, 2540, 3553, 1953, 4985, 3820, 7972]
0563412879	25	3	2	30	[54, 4203, 3125, 8127, 2161, 3148, 2186, 2192, 1321, 2317, 391, 4664, 545, 9619, 9639, 6545, 5863, 1928, 9781, 2711, 3660, 3687, 867, 2859, 3892]	[4101, 8369, 1863]	[1821, 5886]
0780626702	0	2	11	13	[]	[611, 7709]	[3046, 1230, 5231, 509, 4695, 8484, 9642, 3509, 6668, 3860, 8887]
0780631277	0	1	9	10	[]	[6595]	[3047, 9162, 9360, 5664, 5750, 1814, 5842, 3739, 7860]
0783211856	1	5	17	23	[5809]	[338, 1550, 5746, 881, 8982]	[8046, 6151, 1357, 8271, 385, 6341, 414, 1567, 4605, 5607, 9497, 4671, 1675, 559, 4936, 9911, 7799]
0767839129	2	9	45	56	[2593, 6780]	[5082, 3225, 5608, 3419, 4725, 5791, 4883, 8597, 937]	[5076, 7053, 4105, 8076, 106, 5192, 2155, 166, 193, 7171, 9375, 2353, 2363, 6357, 7330, 5627, 3396, 2461, 1649, 528, 548, 8434, 6461, 1714, 4746, 1723, 580, 6492, 8513, 9692, 9726, 2697, 4993, 3652, 9825, 7621, 8711, 7783, 3838, 2967, 2973, 7806, 8861, 7876, 8911]
0782008372	4	3	22	29	[292, 4410, 5528, 4570]	[276, 499, 7946]	[3049, 3074, 4193, 9357, 9385, 400, 2386, 410, 6363, 1561, 8411, 7427, 1738, 3534, 2644, 6570, 2689, 7609, 9962, 6820, 2971, 7957]
0738920339	10	0	0	10	[8048, 1164, 8365, 9550, 5925, 3641, 7643, 2787, 8777, 8916]	[]	[]
0782002064	2	3	5	10	[8438, 8536]	[8209, 9844, 3927]	[6050, 4110, 6243, 7278, 826]
0764007440	39	21	4	64	[5100, 3078, 5196, 5203, 7123, 8146, 1275, 7195, 6219, 3211, 4362, 2261, 1354, 4408, 7275, 9371, 373, 2435, 8406, 3446, 9592, 8460, 635, 8528, 5866, 2641, 1908, 1949, 6654, 6667, 8656, 8685, 8713, 949, 2918, 3827, 7866, 3950, 6961]	[9061, 130, 4176, 3114, 147, 2153, 7210, 6249, 4402, 7235, 6299, 9380, 1520, 7379, 4668, 2625, 8569, 2740, 9864, 6731, 888]	[4318, 6292, 7395, 2783]
0780631641	1	1	10	12	[4630]	[7047]	[8079, 9228, 9305, 8267, 365, 3392, 7524, 3646, 822, 7959]
0780623711	1	0	6	7	[2724]	[]	[5078, 4219, 7264, 4762, 8625, 8921]
0783113943	1	1	9	11	[6964]	[4899]	[8049, 4350, 4665, 4689, 5734, 5790, 6566, 737, 2767]
0767817761	0	3	0	3	[]	[9062, 2138, 9937]	[]
076781777X	0	0	7	7	[]	[]	[4080, 1084, 5085, 375, 5830, 2745, 3715]
0780022823	1	2	3	6	[62]	[5388, 5890]	[3113, 6511, 6875]
0767817745	1	1	1	3	[4081]	[4470]	[5096]
0767809262	3	0	9	12	[9254, 7744, 8826]	[]	[63, 6106, 1283, 4320, 1339, 5419, 497, 7648, 8695]
0780625609	0	2	1	3	[]	[9064, 714]	[7095]
0767018672	18	0	1	19	[2062, 2073, 177, 2179, 2234, 8203, 9322, 540, 4739, 9673, 6543, 1879, 7546, 8665, 7668, 8694, 9923, 7711]	[]	[2830]
0767026977	10	3	0	13	[5083, 9199, 5526, 6348, 425, 6565, 730, 884, 3777, 6844]	[9203, 396, 9878]	[]
0783218842	0	0	3	3	[]	[]	[2063, 6189, 2533]
0767827694	0	0	3	3	[]	[]	[3053, 957, 7891]
0764005448	2	6	2	10	[6271, 3579]	[2148, 1251, 1588, 4629, 9950, 8836]	[1086, 8690]
0783221312	1	2	4	7	[7177]	[7051, 529]	[8373, 3450, 4744, 7679]
0767817648	2	1	2	5	[285, 6624]	[5745]	[4086, 5486]
0767827813	0	0	1	1	[]	[]	[1087]
0780021541	1	3	3	7	[4674]	[8053, 4973, 3972]	[8168, 2397, 4663]
0767836324	0	3	16	19	[]	[6194, 3643, 3713]	[2065, 2102, 119, 8124, 6220, 9284, 8343, 7341, 1851, 1864, 1906, 3658, 848, 6712, 8792, 8900]
0780614097	1	0	4	5	[2899]	[]	[67, 8463, 715, 7602]
0783116330	0	1	1	2	[]	[7233]	[6056]
0783117531	0	0	1	1	[]	[]	[7054]
0780623746	0	2	8	10	[]	[4092, 8522]	[1209, 1316, 2451, 4636, 7390, 1705, 790, 885]
0780022041	0	0	2	2	[]	[]	[3058, 3126]
0783215126	1	0	5	6	[279]	[]	[1094, 7087, 4713, 6782, 8927]
0738920967	16	4	3	23	[7092, 124, 9171, 2187, 9215, 306, 1480, 9395, 397, 7320, 1812, 6632, 2794, 6754, 952, 972]	[5093, 5401, 7851, 8943]	[7517, 1948, 7695]
0738920363	19	1	3	23	[6083, 2156, 1333, 9324, 8289, 7303, 1643, 1655, 532, 1750, 2623, 5868, 6583, 1900, 9945, 8812, 8830, 6975, 7927]	[1950]	[2070, 9086, 2520]
0780612906	0	2	9	11	[]	[4777, 9701]	[4094, 336, 523, 626, 4847, 9807, 2963, 8838, 8896]
0738900370	16	1	2	19	[72, 8081, 9137, 8172, 9225, 8254, 2321, 1452, 4553, 5587, 5602, 5629, 1827, 2781, 8899, 8932]	[2302]	[2099, 7522]
0767818059	1	1	3	5	[3605]	[4721]	[1096, 763, 7634]
0767837371	0	0	6	6	[]	[]	[1097, 3270, 5463, 6386, 5774, 7910]
0767847539	0	0	1	1	[]	[]	[3061]
0767832485	2	1	13	16	[3341, 8487]	[2908]	[6062, 2176, 3161, 4308, 3200, 2331, 9447, 5662, 3489, 5957, 6789, 8752, 3915]
076701135X	7	4	0	11	[5098, 2135, 8409, 4824, 1873, 6740, 3925]	[5269, 2568, 8489, 8574]	[]
0780629868	0	2	5	7	[]	[3153, 4385]	[6063, 6188, 6602, 7720, 8785]
0767821467	0	0	3	3	[]	[]	[4099, 1192, 4254]
0783222068	0	2	3	5	[]	[5099, 3945]	[9183, 437, 755]
076781505X	2	4	9	15	[1102, 1615]	[7382, 5716, 8839, 7847]	[5160, 4164, 7105, 2247, 5789, 7487, 5853, 5897, 8755]
0767812417	0	2	5	7	[]	[5552, 2915]	[78, 2097, 4608, 5685, 7879]
0767811410	1	1	14	16	[4729]	[7719]	[2077, 4138, 3263, 6369, 2433, 8400, 3424, 4792, 9652, 4848, 2660, 2844, 9970, 6850]
0780621948	1	1	1	3	[7062]	[2361]	[427]
0740321757	5	1	2	8	[1163, 4206, 3326, 2699, 6682]	[6786]	[9081, 8984]
0783115377	0	1	7	8	[]	[6233]	[6067, 9445, 452, 8492, 5869, 712, 1968]
0783115202	0	2	13	15	[]	[4901, 2949]	[8065, 6183, 235, 8205, 9306, 4562, 6359, 7432, 4770, 5846, 9769, 3789, 8939]
0783218915	0	1	2	3	[]	[4591]	[7063, 2508]
0767835069	0	0	4	4	[]	[]	[2079, 9290, 6432, 882]
0739040375	4	2	0	6	[4543, 1889, 4968, 8758]	[4109, 5906]	[]
0780023420	0	2	2	4	[]	[1110, 774]	[9487, 4918]
0767834860	1	1	9	11	[8557]	[535]	[4112, 186, 2285, 8441, 4751, 3469, 5748, 3628, 8686]
0780021061	0	1	1	2	[]	[1112]	[7083]
0767825519	0	0	1	1	[]	[]	[3069]
0767853946	1	1	12	14	[5928]	[4611]	[4113, 4291, 5339, 5351, 4412, 9410, 5677, 4708, 5728, 6594, 9980, 7982]
0780621980	2	3	16	21	[5856, 7920]	[4711, 1790, 3520]	[5111, 4357, 6268, 4512, 7304, 8353, 5883, 6585, 6590, 1997, 2789, 3708, 7791, 8810, 2975, 6904]
0767811437	0	1	6	7	[]	[3678]	[5112, 7090, 2158, 5379, 2312, 8922]
0780020693	0	0	3	3	[]	[]	[7067, 2496, 2898]
0780621573	0	2	32	34	[]	[1114, 1825]	[7073, 5154, 3097, 141, 4281, 4282, 4315, 4322, 1387, 9345, 4525, 5517, 4534, 7352, 1587, 8420, 6456, 9599, 4806, 6540, 4873, 707, 6597, 9756, 9767, 8716, 8724, 3784, 6848, 2959, 6896, 3947]
0767023447	4	1	0	5	[4114, 3082, 3202, 1432]	[5572]	[]
078201061X	0	4	4	8	[]	[1115, 388, 6337, 9882]	[7078, 6252, 3278, 8494]
0783214243	1	1	11	13	[4287]	[3075]	[8070, 4147, 7096, 381, 9400, 508, 1689, 4879, 9794, 2874, 8765]
0780023099	0	0	1	1	[]	[]	[9089]
0780619412	3	0	9	12	[4235, 3227, 9647]	[]	[4116, 99, 9198, 9257, 9541, 7470, 4926, 9813, 7677]
0783223609	0	2	6	8	[]	[4117, 9258]	[1276, 1375, 7501, 9672, 4955, 3902]
0767802683	0	1	10	11	[]	[8615]	[90, 9151, 4230, 2200, 3193, 2562, 708, 6658, 934, 976]
0767815963	2	0	4	6	[1118, 5763]	[]	[7157, 5302, 5566, 6960]
0783112750	0	2	5	7	[]	[5785, 8662]	[5116, 5133, 4293, 604, 6727]
0615274641	3	3	17	23	[8071, 8107, 9276]	[1189, 5319, 701]	[5131, 1176, 5429, 4515, 5509, 7338, 9461, 2445, 1660, 8425, 8580, 3603, 2790, 3726, 891, 6917, 3953]
0783113145	1	0	2	3	[4118]	[]	[6186, 8250]
0782010679	1	0	5	6	[1211]	[]	[7070, 4214, 8468, 3516, 3933]
0780628799	0	8	23	31	[]	[1160, 7213, 1400, 8340, 6358, 587, 3657, 9953]	[8072, 2092, 6082, 1158, 5171, 7143, 9234, 5304, 8190, 7193, 4354, 7298, 3409, 5700, 2522, 5769, 9618, 1754, 9669, 9718, 735, 2766, 9852]
0780021592	1	0	3	4	[8073]	[]	[2110, 8259, 7332]
0767839145	0	0	4	4	[]	[]	[4122, 9106, 8152, 4724]
0615837891	7	2	1	10	[7072, 8100, 4526, 4835, 2719, 9849, 8738]	[1308, 7763]	[7599]
0767827686	0	1	2	3	[]	[2376]	[5120, 9335]
0767826728	3	5	24	32	[4123, 5239, 8243]	[8226, 1831, 1871, 9907, 3742]	[6080, 4140, 1140, 2116, 9124, 3150, 3205, 257, 5375, 4396, 3295, 2439, 2460, 6435, 536, 8476, 6620, 3617, 9981, 7754, 3882, 6897, 7905, 8960]
0767847563	0	0	3	3	[]	[]	[5122, 6408, 743]
0782007058	0	0	1	1	[]	[]	[1125]
076781956X	1	3	15	19	[4332]	[2212, 4299, 6914]	[5123, 3129, 3134, 282, 7247, 6294, 1509, 4560, 7337, 4603, 7568, 6689, 7698, 6812, 7848]
0780619951	2	3	15	20	[2786, 851]	[5228, 9184, 4446]	[96, 6102, 2124, 6258, 4583, 3373, 2497, 680, 8568, 2780, 6773, 979, 8851, 3893, 7974]
0780631528	1	5	6	12	[3294]	[320, 4827, 9698, 693, 3610]	[7074, 4246, 1347, 8575, 8605, 6720]
0767824407	1	1	4	6	[3420]	[1127]	[6129, 5753, 6517, 2708]
0780629450	3	1	16	20	[2525, 1926, 3964]	[7321]	[5125, 5193, 1407, 5460, 1474, 2447, 7401, 2530, 2549, 5761, 5780, 5835, 2685, 1981, 948, 2910]
0780622588	1	1	9	11	[7595]	[6395]	[7075, 1201, 9189, 2185, 4485, 6339, 3748, 3787, 2983]
0780018664	0	0	4	4	[]	[]	[1128, 5184, 4601, 6618]
0783112572	1	2	4	7	[1129]	[1434, 624]	[9263, 344, 7439, 9932]
0780626478	1	2	6	9	[8078]	[6352, 574]	[6301, 9391, 8504, 4865, 7557, 2850]
0767811100	1	1	9	11	[1817]	[8458]	[100, 176, 8653, 8712, 8726, 7858, 3917, 3932, 6951]
0780021967	2	5	3	10	[4143, 8895]	[4255, 1328, 9337, 4850, 2912]	[7077, 5447, 4622]
0780023013	1	0	0	1	[4133]	[]	[]
0739600443	1	2	2	5	[1133]	[6206, 4593]	[8181, 1768]
0767837991	1	1	2	4	[9444]	[2098]	[4234, 3792]
0780627849	0	0	4	4	[]	[]	[4136, 5374, 9512, 8518]
0783114176	0	2	0	2	[]	[7079, 7741]	[]
0780020464	1	0	0	1	[3084]	[]	[]
0780618068	0	1	7	8	[]	[426]	[7080, 8136, 9513, 686, 7593, 8614, 967]
0767835093	1	0	5	6	[7482]	[]	[5135, 9210, 6255, 3624, 9983]
0767806743	0	0	3	3	[]	[]	[1138, 1505, 2922]
0767826701	1	0	2	3	[2101]	[]	[2390, 6653]
0780022882	0	0	2	2	[]	[]	[9107, 3959]
0767810856	1	1	3	5	[3993]	[585]	[1142, 9481, 2984]
0780620860	0	1	1	2	[]	[1508]	[2104]
0780022181	2	3	21	26	[5246, 3800]	[4715, 9579, 9719]	[5141, 5162, 5218, 9239, 5329, 7355, 481, 5639, 4803, 9674, 8527, 9716, 1966, 1970, 840, 877, 6772, 2888, 8766, 3837, 7955]
0780629159	1	1	8	10	[4538]	[9223]	[4144, 2183, 4310, 9419, 408, 3501, 6626, 7854]
0767804236	0	1	2	3	[]	[6970]	[6093, 8312]
0740319183	10	1	1	12	[428, 7417, 1742, 5848, 8560, 9824, 7633, 6833, 7882, 3935]	[4661]	[6094]
0767827775	2	1	3	6	[6564, 8707]	[8718]	[1146, 239, 2765]
0782006752	0	0	10	10	[]	[]	[112, 1228, 191, 5312, 6323, 469, 480, 3432, 6609, 2735]
0780020847	0	1	12	13	[]	[1595]	[4148, 4220, 5479, 1529, 5553, 4742, 9744, 1909, 3642, 914, 3822, 2956]
0767081455	23	0	2	25	[6095, 1153, 138, 9196, 7155, 5277, 332, 5439, 4519, 9502, 4681, 4753, 1734, 5776, 5784, 8482, 3518, 3558, 3583, 1998, 7617, 2986, 6911]	[]	[7354, 2580]
0783219660	0	1	3	4	[]	[9204]	[2108, 7681, 6775]
0767815335	2	2	9	13	[9192, 416]	[1168, 3969]	[4152, 7209, 6320, 1514, 5546, 550, 4722, 1886, 8751]
078062856X	1	4	14	19	[2532]	[1296, 1652, 1708, 8817]	[9118, 6383, 7376, 3451, 5756, 7467, 2582, 9675, 1922, 7624, 2834, 986, 8807, 8985]
078062162X	0	1	5	6	[]	[8394]	[9119, 5207, 7183, 8421, 6937]
0767825489	1	1	2	4	[1154]	[9646]	[2706, 2779]
0767817664	1	0	3	4	[3551]	[]	[9121, 5172, 1930]
0783219598	0	1	3	4	[]	[8355]	[2115, 4201, 9717]
0769403468	0	0	4	4	[]	[]	[1161, 5554, 7651, 7688]
0767817729	3	1	7	11	[3170, 2266, 3269]	[9765]	[9125, 5355, 4415, 8326, 9507, 1694, 9896]
0780629876	1	0	2	3	[4765]	[]	[5163, 7490]
0780627024	1	3	7	11	[9460]	[9128, 2543, 3492]	[9154, 340, 1468, 2436, 7375, 9598, 3674]
0782006809	1	1	6	8	[5371]	[1371]	[2121, 6162, 3180, 7180, 9549, 9946]
0782009980	1	1	3	5	[9129]	[3380]	[2151, 7496, 6779]
0780022270	0	1	2	3	[]	[9694]	[4168, 8848]
0738921947	6	1	0	7	[5169, 5274, 8442, 2721, 8644, 6907]	[4860]	[]
0738900672	12	3	1	16	[5170, 2237, 3219, 1395, 6289, 4454, 2474, 8475, 649, 3570, 8647, 897]	[1721, 2916, 3903]	[6794]
0767817710	1	2	17	20	[9829]	[5185, 3906]	[8104, 2127, 6131, 5330, 9272, 4610, 8383, 533, 2539, 6496, 2566, 1787, 2652, 6677, 2776, 2891, 8762]
0767835980	1	0	4	5	[4259]	[]	[7103, 1415, 5604, 6686]
0767009711	3	1	1	5	[5531, 8567, 3815]	[4177]	[7582]
0783204914	0	1	4	5	[]	[9679]	[5178, 5352, 4800, 2668]
0767809335	1	1	5	7	[2132]	[7620]	[4280, 217, 9376, 7350, 4916]
0767827678	0	0	2	2	[]	[]	[1181, 3764]
0767824008	1	1	6	8	[2188]	[2264]	[4185, 1301, 8227, 616, 9682, 3597]
0780626109	1	2	4	7	[8761]	[4466, 7616]	[9145, 1685, 7443, 7800]
0783111037	0	0	1	1	[]	[]	[4189]
0767812174	0	2	3	5	[]	[9146, 335]	[9266, 8427, 8794]
0782009123	1	2	4	7	[5597]	[4377, 6541]	[1187, 8161, 1478, 638]
0783221088	2	4	9	15	[4633, 602]	[5189, 3215, 9526, 6644]	[215, 252, 5505, 5538, 3359, 2510, 4811, 1883, 832]
0764005383	7	2	0	9	[148, 3147, 7168, 1295, 9298, 5709, 2977]	[6309, 3981]	[]
0780022386	0	4	8	12	[]	[6124, 4229, 3258, 871]	[9243, 5324, 3585, 1977, 3661, 2826, 2877, 2929]
0738919012	3	2	0	5	[1194, 5754, 6635]	[3580, 2935]	[]
0767812131	0	1	1	2	[]	[5944]	[151]
0767821807	0	2	4	6	[]	[2144, 155]	[3175, 3187, 3316, 1818]
0767849981	1	1	1	3	[5945]	[2406]	[3122]
0767809726	0	1	1	2	[]	[6868]	[2145]
0780630459	1	3	10	14	[5365]	[3123, 7162, 2657]	[7215, 4387, 8247, 6269, 4532, 1597, 9670, 9721, 2930, 7845]
0780621638	0	1	6	7	[]	[2310]	[6128, 4386, 4427, 1471, 2777, 924]
0767821610	0	0	1	1	[]	[]	[7120]
0783116934	1	0	1	2	[9159]	[]	[4298]
0783112645	0	0	1	1	[]	[]	[5202]
0767810848	0	1	2	3	[]	[2457]	[3128, 2631]
0782011284	0	2	0	2	[]	[9164, 5248]	[]
0783223099	3	0	1	4	[9165, 2295, 5954]	[]	[6744]
0767821742	0	0	5	5	[]	[]	[163, 7196, 1755, 8631, 3794]
0783114885	0	2	4	6	[]	[3472, 3828]	[5210, 5980, 7743, 6860]
076780922X	0	0	5	5	[]	[]	[5211, 4530, 9571, 4956, 7652]
0767813464	0	0	1	1	[]	[]	[9168]
0767835174	1	2	1	4	[7645]	[1414, 2690]	[3133]
0767808673	1	4	18	23	[6616]	[2205, 1286, 4614, 593]	[4218, 4271, 5491, 1492, 454, 9509, 501, 2469, 3505, 9661, 4896, 3589, 9747, 2692, 759, 776, 6788, 3804]
0767819446	1	1	7	9	[7200]	[9561]	[1215, 7161, 8241, 7287, 1664, 5736, 6889]
0767818067	0	1	2	3	[]	[1527]	[6141, 5563]
0767827651	2	1	2	5	[681, 8909]	[170]	[1431, 8470]
0767824032	1	0	1	2	[2163]	[]	[9244]
0780625129	0	2	11	13	[]	[5714, 850]	[1221, 9235, 4505, 2502, 552, 2517, 2567, 2578, 9888, 6829, 6888]
0782007015	2	1	5	8	[280, 3554]	[3913]	[3138, 5333, 1604, 3606, 2870]
0767802551	0	0	8	8	[]	[]	[4231, 5280, 5336, 5470, 5495, 1592, 2626, 2978]
0780020502	0	0	2	2	[]	[]	[7137, 9872]
0783212771	0	0	3	3	[]	[]	[3146, 1789, 8780]
0780621603	1	1	4	6	[2801]	[2172]	[5412, 4969, 6680, 7895]
0767831322	0	1	6	7	[]	[5580]	[6152, 321, 8446, 9609, 3648, 9959]
0783114664	0	1	1	2	[]	[181]	[977]
0783115008	0	1	4	5	[]	[8204]	[4238, 8357, 5752, 8655]
0782010059	0	2	1	3	[]	[1234, 7776]	[7900]
0738921467	7	0	0	7	[183, 7261, 1679, 2531, 1717, 5860, 3629]	[]	[]
0510539610	5	1	0	6	[5236, 432, 2484, 7610, 9894]	[9914]	[]
0767809378	0	0	7	7	[]	[]	[3149, 6422, 9531, 9678, 8622, 3880, 3910]
0767827716	0	1	10	11	[]	[3417]	[6154, 1288, 4325, 8216, 1451, 2506, 561, 9659, 6577, 8946]
0780623614	1	3	14	18	[4336]	[1236, 4769, 8737]	[5377, 2291, 2313, 6366, 3391, 5693, 4730, 1724, 5822, 7553, 2833, 9922, 6867, 6982]
0783222475	1	1	3	5	[8947]	[959]	[9191, 1878, 808]
0767847431	0	0	1	1	[]	[]	[2178]
076782170X	0	1	6	7	[]	[8741]	[1242, 4297, 2669, 968, 6869, 8993]
0615115187	24	2	0	26	[4247, 8163, 2254, 9401, 7309, 1554, 441, 504, 2579, 9650, 4867, 1860, 3561, 1910, 9910, 2878, 9971, 7810, 6906, 7868, 6933, 8937, 8957, 3997]	[1684, 7723]	[]
0780619331	1	2	2	5	[9736]	[6322, 6864]	[7144, 2374]
0767801865	5	0	0	5	[2180, 6192, 1533, 9575, 7631]	[]	[]
0780608372	2	0	9	11	[4462, 6929]	[]	[190, 7237, 9367, 1481, 466, 1600, 2516, 8465, 5942]
078322172X	0	1	12	13	[]	[7683]	[9197, 6203, 3218, 3400, 3498, 5800, 4845, 654, 2650, 2704, 8770, 8847]
0764127861	3	0	4	7	[3156, 4317, 5739]	[]	[322, 601, 8576, 8779]
0780618831	0	1	0	1	[]	[8155]	[]
0783107986	0	2	6	8	[]	[4609, 7818]	[9201, 4344, 576, 1964, 9853, 8748]
0767827791	2	2	8	12	[3293, 7611]	[5254, 6984]	[4277, 439, 7434, 2548, 7509, 4880, 7534, 6688]
0780627776	1	2	6	9	[4444]	[4666, 1983]	[1256, 6315, 9641, 3563, 5974, 6967]
0780622170	0	0	1	1	[]	[]	[4262]
0769721125	0	0	1	1	[]	[]	[5258]
0767810872	0	0	6	6	[]	[]	[4263, 2515, 633, 2703, 7580, 3850]
0782006787	0	0	2	2	[]	[]	[202, 5625]
0780022491	1	1	4	6	[6701]	[8405]	[4266, 3421, 8472, 7589]
0780022084	0	0	3	3	[]	[]	[204, 278, 4897]
0783221983	3	3	5	11	[7158, 378, 8661]	[4269, 3265, 5919]	[8297, 5512, 1979, 3839, 7904]
0783200544	0	3	7	10	[]	[3167, 7518, 7967]	[2197, 2278, 3352, 2423, 9572, 7636, 8908]
0767806808	0	0	3	3	[]	[]	[3168, 7506, 1888]
0767814037	0	0	3	3	[]	[]	[2198, 1390, 5455]
078062775X	0	0	3	3	[]	[]	[5273, 3308, 3622]
0783217471	1	1	0	2	[1454]	[4279]	[]
0780622545	2	6	20	28	[7461, 617]	[237, 9283, 8309, 7300, 4624, 2492]	[2206, 2225, 4397, 9351, 379, 5496, 9418, 4537, 4623, 7426, 2552, 612, 5891, 1933, 4987, 7612, 7647, 876, 6892, 8864]
0780020634	1	3	3	7	[2672]	[8173, 377, 8398]	[1704, 8901, 6968]
0767811070	0	0	2	2	[]	[]	[3176, 9875]
0767805267	1	1	4	6	[259]	[4284]	[2560, 8510, 9886, 7841]
0783113196	0	0	6	6	[]	[]	[3177, 4453, 8479, 7527, 2682, 7708]
0767802578	1	1	6	8	[1913]	[6856]	[1281, 4321, 7377, 1779, 4862, 6737]
0783222149	0	2	3	5	[]	[619, 1807]	[4288, 4565, 7366]
0780021312	1	0	1	2	[5285]	[]	[1401]
0780628519	1	2	7	10	[7500]	[3385, 2737]	[5286, 1352, 3315, 2633, 3680, 6781, 7764]
0782010660	0	1	4	5	[]	[4364]	[4294, 1467, 1958, 7774]
0783200870	1	0	2	3	[5775]	[]	[1287, 2498]
078311611X	1	0	1	2	[702]	[]	[227]
0782007848	0	0	2	2	[]	[]	[1289, 732]
0782010539	0	0	1	1	[]	[]	[7176]
078322365X	1	0	4	5	[6512]	[]	[5296, 9364, 7399, 6702]
0767851013	0	2	8	10	[]	[1753, 7469]	[1297, 4433, 1658, 3447, 1774, 1987, 2788, 3824]
0767840895	0	1	1	2	[]	[7179]	[6529]
078200847X	0	0	1	1	[]	[]	[4306]
076620748X	3	2	1	6	[9314, 3876, 7877]	[3192, 1487]	[2523]
0783210973	1	0	3	4	[7412]	[]	[7182, 2282, 386]
0783114222	0	2	0	2	[]	[1304, 8566]	[]
0767809254	0	1	4	5	[]	[4908]	[246, 5773, 4949, 3691]
0780627717	0	0	3	3	[]	[]	[1313, 9608, 998]
0780022076	0	1	0	1	[]	[7190]	[]
0767804929	0	0	8	8	[]	[]	[6210, 9288, 284, 6425, 3527, 740, 6732, 8790]
0738920770	15	2	4	21	[3231, 6267, 1469, 7322, 417, 7336, 7372, 3395, 8432, 6467, 1941, 9800, 9827, 7941, 3994]	[2258, 866]	[5325, 5456, 1507, 9693]
0783225539	0	0	1	1	[]	[]	[254]
0780627792	0	1	2	3	[]	[3683]	[2240, 3333]
0767801814	6	1	0	7	[4401, 3345, 2499, 3476, 2867, 3968]	[2242]	[]
0767827740	0	1	2	3	[]	[7198]	[9417, 846]
0769720323	0	0	1	1	[]	[]	[1329]
0780625277	1	3	5	9	[9899]	[7199, 3249, 890]	[7277, 2398, 3382, 841, 9920]
0780622030	0	0	2	2	[]	[]	[3212, 4349]
0767815718	0	1	2	3	[]	[5877]	[6222, 9905]
0783225253	2	2	2	6	[1576, 1939]	[3365, 6973]	[2248, 1601]
0780022629	0	0	5	5	[]	[]	[2249, 3281, 7369, 7765, 7795]
076783917X	0	1	3	4	[]	[8783]	[6225, 9574, 8534]
0767857178	0	1	1	2	[]	[2250]	[8878]
0767832566	0	1	3	4	[]	[8720]	[8212, 8531, 9879]
0780621611	0	0	1	1	[]	[]	[9277]
0767850246	0	1	7	8	[]	[9278]	[5404, 3332, 5540, 483, 9524, 556, 6762]
0780620801	0	0	3	3	[]	[]	[2252, 5656, 4740]
0780021118	0	1	2	3	[]	[1549]	[5348, 7770]
0767811097	0	1	13	14	[]	[746]	[5350, 323, 6362, 496, 9546, 594, 6519, 7486, 5819, 733, 4991, 3631, 3669]
0767847121	0	0	1	1	[]	[]	[7208]
0782006930	0	1	5	6	[]	[4866]	[6232, 8256, 1473, 3545, 6846]
0767850661	1	0	4	5	[2259]	[]	[1348, 329, 6280, 7548]
0780020200	0	4	3	7	[]	[1349, 311, 4456, 4841]	[1496, 2528, 8997]
0767818172	1	2	0	3	[1795]	[9285, 9610]	[]
0783219172	1	1	7	9	[6716]	[4683]	[7211, 5394, 2594, 5840, 4977, 7961, 7993]
078322253X	0	2	2	4	[]	[4697, 2896]	[8220, 7773]
0783219105	0	4	5	9	[]	[3540, 7642, 6736, 6993]	[8223, 5502, 636, 644, 2852]
0783116918	0	0	2	2	[]	[]	[7217, 9822]
0783214235	0	2	1	3	[]	[1363, 8604]	[6546]
0780623789	0	1	1	2	[]	[5368]	[3398]
0773386777	2	2	1	5	[9741, 6699]	[9296, 5660]	[435]
078061755X	0	1	1	2	[]	[7449]	[7222]
0767847571	0	1	2	3	[]	[2274]	[1629, 2609]
0780021134	2	1	3	6	[3238, 2615]	[6707]	[4988, 9788, 8880]
0767819764	0	1	4	5	[]	[4917]	[5382, 4628, 8428, 7675]
0783218923	1	0	0	1	[4399]	[]	[]
078060959X	1	0	6	7	[307]	[]	[3274, 6373, 9520, 5794, 7613, 7916]
0783217048	0	1	3	4	[]	[8795]	[5396, 3480, 5961]
0767809246	1	0	6	7	[407]	[]	[3254, 4473, 3478, 8607, 8853, 3905]
0780623215	0	0	1	1	[]	[]	[5407]
0780623258	0	0	3	3	[]	[]	[5410, 1823, 9994]
0767817699	0	0	6	6	[]	[]	[318, 3351, 1709, 3672, 3689, 9908]
0767821718	1	0	3	4	[919]	[]	[1404, 9705, 7825]
078062565X	1	1	4	6	[835]	[9331]	[4672, 6437, 8855, 7971]
0783219733	0	0	2	2	[]	[]	[7246, 5799]
0767812743	0	0	5	5	[]	[]	[2305, 346, 1844, 8676, 8976]
0780023447	0	0	2	2	[]	[]	[3262, 3975]
0780023145	0	0	1	1	[]	[]	[1413]
0782011179	1	0	0	1	[7256]	[]	[]
0767802535	1	1	4	6	[960]	[5764]	[8265, 4451, 1710, 8822]
0780020901	0	0	2	2	[]	[]	[334, 7559]
0767819594	1	2	5	8	[756]	[9347, 5711]	[6478, 595, 831, 6791, 7797]
0783201672	0	1	8	9	[]	[3272]	[1642, 6489, 8497, 8561, 8585, 854, 7732, 6928]
0767819462	0	0	4	4	[]	[]	[337, 1745, 729, 7699]
0780613856	0	0	4	4	[]	[]	[7260, 6578, 4941, 6671]
0783208227	1	0	1	2	[4447]	[]	[5520]
076783822X	2	0	2	4	[5440, 404]	[]	[7271, 9885]
0767823729	2	0	1	3	[2747, 6916]	[]	[1433]
0783213638	0	0	1	1	[]	[]	[4459]
0767804309	1	0	1	2	[5450]	[]	[879]
0783116640	1	0	1	2	[4461]	[]	[9438]
0780613678	0	0	2	2	[]	[]	[8282, 7899]
0780623088	0	0	1	1	[]	[]	[1449]
0767809688	0	0	2	2	[]	[]	[5457, 4905]
0767819624	0	0	3	3	[]	[]	[6300, 3386, 6885]
0780622375	1	0	1	2	[6304]	[]	[676]
0767821505	0	0	5	5	[]	[]	[7284, 5594, 4694, 8516, 1874]
0780627830	0	0	2	2	[]	[]	[4484, 7307]
076780337X	0	1	2	3	[]	[6446]	[1466, 1988]
0783222424	0	0	2	2	[]	[]	[8295, 8700]
0780623592	0	0	2	2	[]	[]	[5480, 1544]
0767855000	0	0	4	4	[]	[]	[4491, 6568, 3718, 9952]
0767814924	0	0	1	1	[]	[]	[3309]
0767856449	0	0	1	1	[]	[]	[4502]
0767823354	0	2	2	4	[]	[9477, 3393]	[6319, 1504]
076785344X	1	0	1	2	[1791]	[]	[1485]
076784730X	0	1	0	1	[]	[1495]	[]
078062579X	0	0	1	1	[]	[]	[5514]
0767804325	0	0	1	1	[]	[]	[9412]
0783225482	1	1	1	3	[6537]	[4527]	[4604]
078062338X	0	0	1	1	[]	[]	[6336]
0767835948	0	2	7	9	[]	[1897, 7550]	[8322, 5573, 9559, 6535, 2664, 1989, 815]
0767819179	0	1	1	2	[]	[6953]	[2382]
0780625358	0	0	1	1	[]	[]	[8327]
0783215088	1	1	0	2	[2744]	[5539]	[]
0780021932	0	1	0	1	[]	[4551]	[]
0780627873	0	1	3	4	[]	[5798]	[9433, 538, 6946]
0767811054	1	0	0	1	[3342]	[]	[]
0783215517	0	0	1	1	[]	[]	[7328]
0767847202	0	1	1	2	[]	[8558]	[5557]
0767827635	0	0	1	1	[]	[]	[5560]
076784436X	0	0	1	1	[]	[]	[1552]
078321541X	0	0	1	1	[]	[]	[2414]
0783225504	1	0	2	3	[5854]	[]	[1559, 5997]
0767818083	0	0	2	2	[]	[]	[2415, 7938]
0780622383	0	0	2	2	[]	[]	[8354, 2598]
0767818105	0	0	2	2	[]	[]	[447, 7785]
0783114583	0	2	1	3	[]	[1566, 3614]	[6462]
0780625803	0	0	1	1	[]	[]	[1570]
0767018907	3	1	4	8	[6483, 5795, 928]	[457]	[5960, 7704, 7726, 6863]
0780627865	0	1	0	1	[]	[8367]	[]
0767812115	0	1	2	3	[]	[516]	[2437, 8942]
0767811429	0	0	4	4	[]	[]	[1590, 7663, 8802, 8854]
0780613880	0	0	2	2	[]	[]	[6392, 725]
0780621549	0	0	3	3	[]	[]	[5617, 1666, 8674]
0767808460	0	0	1	1	[]	[]	[7373]
0783116896	0	0	1	1	[]	[]	[9511]
0780021940	0	0	3	3	[]	[]	[5642, 572, 2535]
0767840135	0	0	1	1	[]	[]	[2467]
0780020227	0	1	5	6	[]	[2792]	[9518, 9696, 8545, 2754, 6996]
0782008364	0	1	5	6	[]	[3408]	[1764, 6513, 6628, 813, 3692]
0780630548	0	0	1	1	[]	[]	[7388]
0767850823	0	1	1	2	[]	[2472]	[8483]
0767850262	0	0	2	2	[]	[]	[1638, 641]
0783105533	1	0	3	4	[878]	[]	[7402, 4814, 2902]
0767815122	1	0	0	1	[525]	[]	[]
0767832248	0	0	1	1	[]	[]	[3427]
0767819381	0	0	2	2	[]	[]	[2493, 3782]
0780619439	0	1	1	2	[]	[6836]	[5683]
0767819543	0	0	2	2	[]	[]	[1667, 9816]
0782006760	0	0	3	3	[]	[]	[6439, 6584, 8919]
0780619536	0	0	1	1	[]	[]	[6441]
0783114532	0	1	0	1	[]	[4707]	[]
0783222548	0	0	2	2	[]	[]	[5701, 6500]
0783112610	1	1	0	2	[9997]	[7421]	[]
0783217358	1	1	0	2	[3979]	[2514]	[]
0783116926	0	1	2	3	[]	[7435]	[5720, 7504]
0767802616	0	1	4	5	[]	[7438]	[5832, 772, 9833, 3952]
0780624378	0	3	0	3	[]	[6477, 1986, 6806]	[]
0769720994	0	0	1	1	[]	[]	[9596]
076784257X	1	0	1	2	[1727]	[]	[9887]
0767833600	0	1	1	2	[]	[8461]	[8553]
0767825616	0	1	2	3	[]	[1996]	[9604, 3647]
0783217390	0	0	4	4	[]	[]	[1739, 4799, 4828, 3857]
0780021185	0	0	2	2	[]	[]	[4773, 8617]
0773386726	0	0	1	1	[]	[]	[1744]
0780023536	0	0	1	1	[]	[]	[600]
0767830806	0	0	1	1	[]	[]	[9621]
0783110871	0	0	2	2	[]	[]	[2565, 3754]
0767837363	0	1	0	1	[]	[1775]	[]
0780662911	0	0	2	2	[]	[]	[618, 7947]
0780020731	0	1	4	5	[]	[3728]	[623, 2606, 3757, 985]
0780622278	0	1	0	1	[]	[625]	[]
078311494X	0	0	1	1	[]	[]	[2592]
0783217536	0	0	1	1	[]	[]	[5820]
0780631323	0	1	0	1	[]	[4834]	[]
0780020804	0	0	1	1	[]	[]	[5826]
0769720382	1	0	0	1	[645]	[]	[]
0780620364	0	0	1	1	[]	[]	[8512]
0783114338	0	1	1	2	[]	[647]	[9758]
0780607287	0	0	2	2	[]	[]	[5845, 4982]
0767827902	0	1	2	3	[]	[3626]	[9690, 922]
076780676X	0	0	1	1	[]	[]	[1842]
0767819470	1	0	1	2	[4875]	[]	[987]
0780022319	0	0	1	1	[]	[]	[1856]
0767821920	0	0	1	1	[]	[]	[5881]
078200833X	0	1	1	2	[]	[2649]	[7530]
0783219148	0	1	0	1	[]	[2645]	[]
0780626516	0	0	1	1	[]	[]	[7542]
0783114729	0	0	2	2	[]	[]	[711, 9793]
0780020618	0	1	1	2	[]	[719]	[8743]
0780020707	0	0	1	1	[]	[]	[2680]
076780760X	1	0	1	2	[792]	[]	[5946]
0767848535	0	0	1	1	[]	[]	[4960]
0783114907	0	0	2	2	[]	[]	[6611, 8606]
0782011276	0	0	1	1	[]	[]	[7570]
0780630149	0	0	1	1	[]	[]	[3620]
0767821483	0	0	1	1	[]	[]	[9783]
0780625773	0	0	1	1	[]	[]	[4997]
0767809548	0	1	2	3	[]	[9991]	[9801, 3977]
076782184X	0	1	0	1	[]	[9804]	[]
0767807693	0	0	1	1	[]	[]	[2736]
0783213115	0	0	1	1	[]	[]	[7605]
0767844386	0	0	1	1	[]	[]	[3655]
0783116780	0	1	1	2	[]	[2753]	[8933]
076781214X	0	1	2	3	[]	[8732]	[2764, 2927]
0767804341	0	0	2	2	[]	[]	[9839, 8924]
0780018648	0	1	0	1	[]	[3670]	[]
0780620879	0	0	1	1	[]	[]	[8643]
0767816641	0	1	1	2	[]	[6943]	[9846]
0780620372	0	0	1	1	[]	[]	[9860]
0780029410	0	0	1	1	[]	[]	[9868]
0780022122	0	0	1	1	[]	[]	[6700]
0780630106	0	0	1	1	[]	[]	[868]
0767812166	1	0	1	2	[7944]	[]	[3732]
0783207425	0	0	1	1	[]	[]	[9939]
0783205945	1	1	0	2	[9979]	[929]	[]
0767812387	0	1	0	1	[]	[2875]	[]
0783224060	0	0	1	1	[]	[]	[8750]
0783104146	0	0	1	1	[]	[]	[6798]
0780020987	0	0	1	1	[]	[]	[8756]
0783116764	0	1	0	1	[]	[7747]	[]
0780020715	0	0	1	1	[]	[]	[974]
0780627857	0	0	1	1	[]	[]	[2928]
0773345019	0	0	2	2	[]	[]	[6838, 8945]
0783224885	1	0	0	1	[2966]	[]	[]
0780021045	1	0	1	2	[2969]	[]	[6884]
0783114877	0	0	1	1	[]	[]	[3862]
0767807596	0	0	1	1	[]	[]	[6900]
0783224788	0	0	1	1	[]	[]	[8885]
078002320X	0	0	1	1	[]	[]	[7881]
0780630068	0	0	1	1	[]	[]	[8920]
0780019164	0	0	1	1	[]	[]	[7930]
